id,year,ENTIDAD,MUNICIPIO,hom_rate,Servicios Comunitarios,Infraestructura,Proyectos Productivos,Total 3x1
1001,2014,AGUASCALIENTES,AGUASCALIENTES,3.889537145079735,1,4,1,6
1002,2014,AGUASCALIENTES,ASIENTOS,0.0,2,6,1,9
1003,2014,AGUASCALIENTES,CALVILLO,3.694399290675336,3,2,5,10
1004,2014,AGUASCALIENTES,COSIO,0.0,2,3,0,5
1005,2014,AGUASCALIENTES,JESUS MARIA,6.024701275228437,0,0,2,2
1006,2014,AGUASCALIENTES,PABELLON DE ARTEAGA,0.0,1,0,0,1
1007,2014,AGUASCALIENTES,RINCON DE ROMOS,2.034339653348523,1,2,0,3
1008,2014,AGUASCALIENTES,SAN JOSE DE GRACIA,0.0,1,2,0,3
1009,2014,AGUASCALIENTES,TEPEZALA,0.0,2,1,1,4
1011,2014,AGUASCALIENTES,SAN FRANCISCO DE LOS ROMO,2.795716961614806,1,0,0,1
2001,2014,BAJA CALIFORNIA,ENSENADA,10.710904128839323,0,1,0,1
2004,2014,BAJA CALIFORNIA,TIJUANA,29.621403836548836,10,3,2,15
2005,2014,BAJA CALIFORNIA,PLAYAS DE ROSARITO,49.63162306436671,1,1,4,6
4001,2014,CAMPECHE,CALKINI,1.8907165815844207,0,2,0,2
4004,2014,CAMPECHE,CHAMPOTON,9.636116163380349,1,1,2,4
4007,2014,CAMPECHE,PALIZADA,0.0,0,1,0,1
4008,2014,CAMPECHE,TENABO,0.0,0,1,0,1
4009,2014,CAMPECHE,ESCARCEGA,9.227816329543778,0,1,1,2
4010,2014,CAMPECHE,CALAKMUL,7.439922624804702,0,2,0,2
4011,2014,CAMPECHE,CANDELARIA,24.275379909695584,0,1,0,1
6002,2014,COLIMA,COLIMA,13.614333169961336,3,8,0,11
6003,2014,COLIMA,COMALA,14.362313289927233,0,2,0,2
6005,2014,COLIMA,CUAUHTEMOC,14.756336001770759,1,0,0,1
6006,2014,COLIMA,IXTLAHUACAN,0.0,0,6,0,6
6007,2014,COLIMA,MANZANILLO,13.629042250030976,0,12,0,12
6008,2014,COLIMA,MINATITLAN,36.701737215561536,0,3,0,3
6009,2014,COLIMA,TECOMAN,19.51634937813814,0,9,0,9
6010,2014,COLIMA,VILLA DE ALVAREZ,6.66911200773617,0,1,0,1
7002,2014,CHIAPAS,ACALA,10.36376826614157,0,0,1,1
7009,2014,CHIAPAS,ARRIAGA,32.465910793666644,0,0,3,3
7017,2014,CHIAPAS,CINTALAPA,8.961261745653788,0,5,0,5
7032,2014,CHIAPAS,ESCUINTLA,13.303179459890915,0,0,1,1
7041,2014,CHIAPAS,LA INDEPENDENCIA,0.0,0,5,0,5
7044,2014,CHIAPAS,IXTAPA,4.078802463596688,0,0,1,1
7052,2014,CHIAPAS,LAS MARGARITAS,2.690969107674644,0,0,1,1
7057,2014,CHIAPAS,MOTOZINTLA,5.787120762742516,0,4,0,4
7061,2014,CHIAPAS,OCOZOCOAUTLA DE ESPINOSA,7.3118122326618655,0,0,1,1
7064,2014,CHIAPAS,OXCHUC,2.306805074971165,0,0,1,1
7069,2014,CHIAPAS,PIJIJIAPAN,7.987379939695282,0,3,0,3
7092,2014,CHIAPAS,TECPATAN,14.618102083079547,0,0,1,1
7097,2014,CHIAPAS,TONALA,7.092701610043266,0,5,0,5
7099,2014,CHIAPAS,LA TRINITARIA,4.122634638376232,0,0,1,1
7101,2014,CHIAPAS,TUXTLA GUTIERREZ,7.589803640937233,1,1,1,3
7103,2014,CHIAPAS,TUZANTAN,3.5540391655116044,0,1,0,1
7104,2014,CHIAPAS,TZIMOL,0.0,0,0,1,1
7107,2014,CHIAPAS,VILLA CORZO,13.426964029163367,0,0,1,1
7108,2014,CHIAPAS,VILLAFLORES,1.0140136689042567,0,5,0,5
7110,2014,CHIAPAS,SAN LUCAS,0.0,0,0,2,2
7111,2014,CHIAPAS,ZINACANTAN,2.7405519471621584,0,0,1,1
8006,2014,CHIHUAHUA,BACHINIVA,16.636167027116954,1,0,0,1
8009,2014,CHIHUAHUA,BOCOYNA,97.33713411666551,1,0,0,1
8013,2014,CHIHUAHUA,CASAS GRANDES,28.336639274582037,0,1,0,1
8017,2014,CHIHUAHUA,CUAUHTEMOC,24.573361183142676,1,0,0,1
8018,2014,CHIHUAHUA,CUSIHUIRIACHI,18.470631695603988,1,0,0,1
8019,2014,CHIHUAHUA,CHIHUAHUA,22.451537015141366,3,0,0,3
8022,2014,CHIHUAHUA,DR. BELISARIO DOMINGUEZ,34.35245620061835,1,0,0,1
8023,2014,CHIHUAHUA,GALEANA,0.0,1,0,0,1
8024,2014,CHIHUAHUA,SANTA ISABEL,25.400050800101596,2,0,0,2
8025,2014,CHIHUAHUA,GOMEZ FARIAS,0.0,2,0,0,2
8026,2014,CHIHUAHUA,GRAN MORELOS,93.48706762231225,1,0,0,1
8027,2014,CHIHUAHUA,GUACHOCHI,82.51323230493671,1,0,0,1
8031,2014,CHIHUAHUA,GUERRERO,27.759551809418056,1,0,0,1
8034,2014,CHIHUAHUA,IGNACIO ZARAGOZA,14.421690222094028,1,0,0,1
8036,2014,CHIHUAHUA,JIMENEZ,58.160668847691745,2,0,0,2
8039,2014,CHIHUAHUA,LOPEZ,24.84472049689441,2,0,0,2
8040,2014,CHIHUAHUA,MADERA,23.639863564216,1,1,0,2
8045,2014,CHIHUAHUA,MEOQUI,27.376634042844433,2,0,0,2
8046,2014,CHIHUAHUA,MORELOS,95.88876902792761,1,0,0,1
8047,2014,CHIHUAHUA,MORIS,94.12650602409639,1,0,0,1
8048,2014,CHIHUAHUA,NAMIQUIPA,17.482517482517483,2,0,0,2
8049,2014,CHIHUAHUA,NONOAVA,0.0,1,0,0,1
8050,2014,CHIHUAHUA,NUEVO CASAS GRANDES,13.482312890776413,1,2,0,3
8051,2014,CHIHUAHUA,OCAMPO,39.7561622051418,1,0,0,1
8054,2014,CHIHUAHUA,RIVA PALACIO,24.962556165751376,1,0,0,1
8057,2014,CHIHUAHUA,SAN FRANCISCO DE BORJA,0.0,1,0,0,1
8063,2014,CHIHUAHUA,TEMOSACHIC,80.50233456770246,1,0,0,1
8066,2014,CHIHUAHUA,URUACHI,73.17073170731707,1,0,0,1
10001,2014,DURANGO,CANATLAN,9.553835865099838,0,3,0,3
10002,2014,DURANGO,CANELAS,0.0,0,2,0,2
10004,2014,DURANGO,CUENCAME,11.88212927756654,0,1,0,1
10005,2014,DURANGO,DURANGO,7.556670736964314,0,9,0,9
10006,2014,DURANGO,GENERAL SIMON BOLIVAR,0.0,0,5,0,5
10008,2014,DURANGO,GUADALUPE VICTORIA,0.0,0,7,0,7
10009,2014,DURANGO,GUANACEVI,39.41275002463297,0,3,0,3
10010,2014,DURANGO,HIDALGO,0.0,0,2,0,2
10011,2014,DURANGO,INDE,0.0,0,11,0,11
10013,2014,DURANGO,MAPIMI,19.890997334606357,0,4,0,4
10015,2014,DURANGO,NAZAS,8.057368463459834,0,4,0,4
10016,2014,DURANGO,NOMBRE DE DIOS,0.0,0,5,0,5
10017,2014,DURANGO,OCAMPO,0.0,0,1,0,1
10018,2014,DURANGO,EL ORO,35.33568904593639,0,3,0,3
10020,2014,DURANGO,PANUCO DE CORONADO,16.768676113020877,0,5,0,5
10021,2014,DURANGO,PE?ON BLANCO,0.0,0,9,0,9
10022,2014,DURANGO,POANAS,8.026326350429407,0,6,0,6
10024,2014,DURANGO,RODEO,0.0,0,10,0,10
10025,2014,DURANGO,SAN BERNARDO,0.0,0,4,0,4
10027,2014,DURANGO,SAN JUAN DE GUADALUPE,0.0,0,2,0,2
10028,2014,DURANGO,SAN JUAN DEL RIO,25.305778152678194,0,3,0,3
10029,2014,DURANGO,SAN LUIS DEL CORDERO,0.0,0,4,0,4
10030,2014,DURANGO,SAN PEDRO DEL GALLO,0.0,0,1,0,1
10031,2014,DURANGO,SANTA CLARA,0.0,0,2,0,2
10034,2014,DURANGO,TAMAZULA,159.28398058252426,0,2,0,2
10035,2014,DURANGO,TEPEHUANES,83.75988832014892,0,16,0,16
10036,2014,DURANGO,TLAHUALILO,8.991188635137565,0,15,0,15
10037,2014,DURANGO,TOPIA,0.0,0,4,0,4
10038,2014,DURANGO,VICENTE GUERRERO,9.471042288203817,0,7,0,7
10039,2014,DURANGO,NUEVO IDEAL,3.832592365476008,0,3,0,3
11001,2014,GUANAJUATO,ABASOLO,1.1857894986482,0,0,1,1
11002,2014,GUANAJUATO,ACAMBARO,30.26689901861873,0,16,0,16
11004,2014,GUANAJUATO,APASEO EL ALTO,6.207999006720159,0,4,0,4
11005,2014,GUANAJUATO,APASEO EL GRANDE,8.2045031001301,0,2,0,2
11009,2014,GUANAJUATO,COMONFORT,10.283569426948093,0,1,0,1
11010,2014,GUANAJUATO,CORONEO,25.660764690787786,0,24,0,24
11011,2014,GUANAJUATO,CORTAZAR,20.3626819914703,0,5,0,5
11013,2014,GUANAJUATO,DOCTOR MORA,12.862287772251758,0,34,0,34
11015,2014,GUANAJUATO,GUANAJUATO,8.735709834662131,0,5,0,5
11016,2014,GUANAJUATO,HUANIMARO,0.0,0,1,0,1
11017,2014,GUANAJUATO,IRAPUATO,10.954971290420067,0,0,1,1
11019,2014,GUANAJUATO,JERECUARO,31.47623544224111,0,18,0,18
11020,2014,GUANAJUATO,LEON,11.556025840944532,0,14,12,26
11021,2014,GUANAJUATO,MOROLEON,28.36074872376631,0,1,0,1
11022,2014,GUANAJUATO,OCAMPO,0.0,0,11,0,11
11024,2014,GUANAJUATO,PUEBLO NUEVO,35.81341212284,0,0,4,4
11025,2014,GUANAJUATO,PURISIMA DEL RINCON,2.907188022385348,0,5,0,5
11026,2014,GUANAJUATO,ROMITA,10.590415673815198,0,1,3,4
11027,2014,GUANAJUATO,SALAMANCA,14.95788779282942,0,0,1,1
11028,2014,GUANAJUATO,SALVATIERRA,14.424959301007686,0,5,0,5
11029,2014,GUANAJUATO,SAN DIEGO DE LA UNION,5.3903996981376165,0,40,0,40
11031,2014,GUANAJUATO,SAN FRANCISCO DEL RINCON,13.20771330456987,0,6,3,9
11032,2014,GUANAJUATO,SAN JOSE ITURBIDE,8.28603388987861,0,5,0,5
11033,2014,GUANAJUATO,SAN LUIS DE LA PAZ,6.052431348135851,2,1,0,3
11035,2014,GUANAJUATO,SANTA CRUZ DE JUVENTINO ROSAS,18.936046658418967,0,5,0,5
11036,2014,GUANAJUATO,SANTIAGO MARAVATIO,0.0,1,23,0,24
11038,2014,GUANAJUATO,TARANDACUAO,42.951636457349025,0,5,0,5
11042,2014,GUANAJUATO,VALLE DE SANTIAGO,10.633923634249742,0,2,8,10
11044,2014,GUANAJUATO,VILLAGRAN,23.305008784195618,0,6,8,14
11046,2014,GUANAJUATO,YURIRIA,12.715097058574214,0,2,5,7
12001,2014,GUERRERO,ACAPULCO DE JUAREZ,74.68628595226913,0,0,1,1
12006,2014,GUERRERO,APAXTLA,64.57341189765114,1,3,1,5
12008,2014,GUERRERO,ATENANGO DEL RIO,11.918951132300357,0,1,0,1
12011,2014,GUERRERO,ATOYAC DE ALVAREZ,61.974036140648444,3,3,0,6
12012,2014,GUERRERO,AYUTLA DE LOS LIBRES,17.546658159196046,0,1,0,1
12014,2014,GUERRERO,BENITO JUAREZ,33.291164524935084,2,1,0,3
12015,2014,GUERRERO,BUENAVISTA DE CUELLAR,15.762925598991172,0,10,0,10
12016,2014,GUERRERO,COAHUAYUTLA DE JOSE MARIA IZAZAGA,15.355086372360844,0,1,0,1
12017,2014,GUERRERO,COCULA,20.398449717821446,0,13,0,13
12021,2014,GUERRERO,COYUCA DE BENITEZ,65.34168254832562,1,0,0,1
12028,2014,GUERRERO,CHILAPA DE ALVAREZ,45.533570659822836,0,1,0,1
12029,2014,GUERRERO,CHILPANCINGO DE LOS BRAVO,68.67535175432428,1,1,0,2
12033,2014,GUERRERO,HUAMUXTITLAN,34.739109289237824,0,1,0,1
12034,2014,GUERRERO,HUITZUCO DE LOS FIGUEROA,21.410983834707206,0,2,0,2
12035,2014,GUERRERO,IGUALA DE LA INDEPENDENCIA,52.00800780832556,4,19,0,23
12037,2014,GUERRERO,IXCATEOPAN DE CUAUHTEMOC,30.289262456459184,0,2,0,2
12039,2014,GUERRERO,JUAN R. ESCUDERO,24.62649811196848,1,0,0,1
12044,2014,GUERRERO,MOCHITLAN,0.0,0,1,1,2
12048,2014,GUERRERO,PETATLAN,13.339558460614953,1,0,0,1
12049,2014,GUERRERO,PILCAYA,25.956047759127873,0,3,0,3
12051,2014,GUERRERO,QUECHULTENANGO,5.759041695461875,1,0,0,1
12055,2014,GUERRERO,TAXCO DE ALARCON,18.259925230411422,0,27,0,27
12057,2014,GUERRERO,TECPAN DE GALEANA,37.054340996600665,2,0,0,2
12058,2014,GUERRERO,TELOLOAPAN,81.8315386189068,6,1,1,8
12059,2014,GUERRERO,TEPECOACUILCO DE TRUJANO,3.281916639317361,0,1,0,1
12060,2014,GUERRERO,TETIPAC,7.617306520414382,0,5,0,5
12061,2014,GUERRERO,TIXTLA DE GUERRERO,34.94932348095262,3,0,0,3
12067,2014,GUERRERO,TLAPEHUALA,22.915807323892018,0,2,1,3
12068,2014,GUERRERO,LA UNION DE ISIDORO MONTES DE OCA,93.34163036714375,0,1,0,1
12080,2014,GUERRERO,JUCHITAN,13.954786491766678,0,3,2,5
13001,2014,HIDALGO,ACATLAN,4.980823828261195,0,1,0,1
13002,2014,HIDALGO,ACAXOCHITLAN,2.4640859473178423,0,1,0,1
13003,2014,HIDALGO,ACTOPAN,3.683309084881858,1,9,0,10
13006,2014,HIDALGO,ALFAJAYUCAN,0.0,0,2,1,3
13007,2014,HIDALGO,ALMOLOYA,0.0,0,2,0,2
13009,2014,HIDALGO,EL ARENAL,0.0,0,3,0,3
13010,2014,HIDALGO,ATITALAQUIA,0.0,0,1,0,1
13011,2014,HIDALGO,ATLAPEXCO,0.0,0,3,0,3
13012,2014,HIDALGO,ATOTONILCO EL GRANDE,11.1358574610245,0,3,2,5
13014,2014,HIDALGO,CALNALI,5.895531187359981,0,2,0,2
13018,2014,HIDALGO,CHAPULHUACAN,4.463887152932774,0,1,0,1
13022,2014,HIDALGO,EPAZOYUCAN,7.230657989877079,0,3,1,4
13025,2014,HIDALGO,HUAUTLA,0.0,0,1,0,1
13028,2014,HIDALGO,HUEJUTLA DE REYES,4.068182742768805,0,2,0,2
13029,2014,HIDALGO,HUICHAPAN,6.7792014100738935,0,3,0,3
13030,2014,HIDALGO,IXMIQUILPAN,4.6316130750437114,0,5,3,8
13034,2014,HIDALGO,LOLOTLA,0.0,0,2,0,2
13036,2014,HIDALGO,SAN AGUSTIN METZQUITITLAN,10.679196924391286,0,3,0,3
13040,2014,HIDALGO,LA MISION,9.567546880979718,1,1,0,2
13041,2014,HIDALGO,MIXQUIAHUALA DE JUAREZ,2.3345940141009476,0,1,0,1
13042,2014,HIDALGO,MOLANGO DE ESCAMILLA,8.92140244446427,0,3,0,3
13043,2014,HIDALGO,NICOLAS FLORES,0.0,0,1,0,1
13048,2014,HIDALGO,PACHUCA DE SOTO,8.586510964601176,0,0,2,2
13051,2014,HIDALGO,MINERAL DE LA REFORMA,2.3547141377036827,0,3,3,6
13054,2014,HIDALGO,SAN SALVADOR,3.0512922222561256,1,6,0,7
13056,2014,HIDALGO,SANTIAGO TULANTEPEC DE LUGO GUERRERO,5.971040453799075,0,4,0,4
13057,2014,HIDALGO,SINGUILUCAN,0.0,0,0,1,1
13058,2014,HIDALGO,TASQUILLO,0.0,1,4,0,5
13061,2014,HIDALGO,TEPEAPULCO,5.806751316196965,0,1,0,1
13066,2014,HIDALGO,VILLA DE TEZONTEPEC,25.74223442594817,0,1,1,2
13072,2014,HIDALGO,TLANALAPA,0.0,0,2,0,2
13074,2014,HIDALGO,TLAXCOAPAN,0.0,0,1,0,1
13077,2014,HIDALGO,TULANCINGO DE BRAVO,5.937302089930335,0,1,0,1
13083,2014,HIDALGO,ZEMPOALA,7.664205605089033,0,3,0,3
14001,2014,,,,0,6,0,6
14004,2014,,,,0,6,0,6
14006,2014,,,,0,0,1,1
14010,2014,,,,1,1,0,2
14011,2014,,,,0,3,0,3
14012,2014,,,,0,1,0,1
14013,2014,,,,0,2,0,2
14014,2014,,,,0,3,0,3
14015,2014,,,,0,3,0,3
14016,2014,,,,0,12,0,12
14017,2014,,,,0,4,0,4
14026,2014,,,,0,16,0,16
14027,2014,,,,0,4,0,4
14028,2014,,,,1,0,0,1
14029,2014,,,,0,2,0,2
14031,2014,,,,0,1,0,1
14032,2014,,,,0,4,0,4
14033,2014,,,,0,2,0,2
14034,2014,,,,0,2,0,2
14037,2014,,,,1,0,0,1
14038,2014,,,,1,0,0,1
14039,2014,JALISCO,GUADALAJARA,6.35371180499589,1,0,10,11
14040,2014,,,,0,2,0,2
14042,2014,,,,1,1,0,2
14043,2014,,,,0,6,0,6
14045,2014,,,,0,2,0,2
14046,2014,,,,0,10,0,10
14047,2014,,,,0,1,0,1
14050,2014,,,,1,0,0,1
14052,2014,,,,0,7,1,8
14053,2014,JALISCO,LAGOS DE MORENO,7.151355181806953,1,0,0,1
14054,2014,,,,0,4,0,4
14055,2014,,,,0,4,0,4
14056,2014,,,,0,3,0,3
14058,2014,,,,0,1,1,2
14060,2014,,,,1,5,0,6
14064,2014,,,,0,3,0,3
14066,2014,,,,0,6,0,6
14067,2014,JALISCO,PUERTO VALLARTA,7.04002252807209,0,1,0,1
14068,2014,,,,0,3,0,3
14069,2014,,,,0,4,0,4
14070,2014,JALISCO,EL SALTO,20.980133983476335,2,0,0,2
14071,2014,,,,0,1,0,1
14074,2014,,,,0,10,0,10
14076,2014,,,,0,1,0,1
14077,2014,,,,1,0,0,1
14078,2014,,,,0,22,0,22
14079,2014,,,,0,6,1,7
14081,2014,,,,0,0,1,1
14083,2014,,,,0,13,0,13
14084,2014,,,,0,4,0,4
14085,2014,,,,0,3,0,3
14086,2014,,,,0,3,0,3
14088,2014,,,,0,8,0,8
14091,2014,,,,0,3,0,3
14096,2014,,,,0,2,0,2
14099,2014,,,,0,3,0,3
14100,2014,,,,0,1,0,1
14101,2014,JALISCO,TONALA,10.445195105799382,3,0,1,4
14102,2014,,,,0,4,0,4
14106,2014,,,,0,5,1,6
14107,2014,,,,0,7,0,7
14109,2014,,,,0,12,0,12
14113,2014,,,,0,6,0,6
14115,2014,,,,0,5,0,5
14116,2014,,,,0,11,0,11
14117,2014,,,,0,6,0,6
14118,2014,,,,1,6,2,9
14119,2014,,,,0,3,0,3
14120,2014,JALISCO,ZAPOPAN,7.959760596129788,0,0,3,3
14121,2014,,,,0,8,0,8
14125,2014,,,,0,24,0,24
15001,2014,MEXICO,ACAMBAY,4.924652811976756,0,1,0,1
15004,2014,MEXICO,ALMOLOYA DE ALQUISIRAS,6.731287022078622,0,1,0,1
15005,2014,MEXICO,ALMOLOYA DE JUAREZ,2.7090543368573616,0,1,0,1
15008,2014,MEXICO,AMATEPEC,22.784233310549098,0,1,2,3
15016,2014,MEXICO,AXAPUSCO,19.56258069564537,1,0,0,1
15021,2014,MEXICO,COATEPEC HARINAS,8.29324929507381,0,1,2,3
15041,2014,MEXICO,IXTAPAN DEL ORO,0.0,0,1,0,1
15048,2014,MEXICO,JOCOTITLAN,0.0,0,1,0,1
15052,2014,MEXICO,MALINALCO,15.610365282547612,1,0,0,1
15056,2014,MEXICO,MORELOS,14.071624569056496,0,1,0,1
15064,2014,MEXICO,EL ORO,0.0,0,1,0,1
15066,2014,MEXICO,OTZOLOAPAN,41.118421052631575,0,1,0,1
15071,2014,MEXICO,POLOTITLAN,0.0,0,1,0,1
15075,2014,MEXICO,SAN MARTIN DE LAS PIRAMIDES,12.071948814937024,0,1,0,1
15079,2014,MEXICO,SOYANIQUILPAN DE JUAREZ,25.42803865061875,0,1,0,1
15082,2014,MEXICO,TEJUPILCO,9.848474189962998,1,0,3,4
15084,2014,MEXICO,TEMASCALAPA,25.0090310389863,0,1,0,1
15085,2014,MEXICO,TEMASCALCINGO,7.975117632985087,0,1,0,1
15086,2014,MEXICO,TEMASCALTEPEC,24.33830240340736,0,0,1,1
15087,2014,MEXICO,TEMOAYA,9.998889012331963,0,1,0,1
15088,2014,MEXICO,TENANCINGO,3.298660743738042,0,1,0,1
15097,2014,MEXICO,TEXCALTITLAN,5.750431282346176,0,0,1,1
15101,2014,MEXICO,TIANGUISTENCO,9.903511502221216,1,0,0,1
15102,2014,MEXICO,TIMILPAN,0.0,0,1,0,1
15107,2014,MEXICO,TONATICO,8.265145879824779,0,1,0,1
15117,2014,MEXICO,ZACUALPAN,26.45327689967595,1,0,0,1
15118,2014,MEXICO,ZINACANTEPEC,7.153118461602656,0,1,0,1
15120,2014,MEXICO,ZUMPANGO,8.142965417452254,0,1,0,1
15123,2014,MEXICO,LUVIANOS,39.5954069327958,0,1,0,1
15124,2014,MEXICO,SAN JOSE DEL RINCON,2.189501341069571,0,1,0,1
16003,2014,MICHOACAN,ALVARO OBREGON,14.345144168698896,2,1,1,4
16006,2014,MICHOACAN,APATZINGAN,35.58459833884625,0,1,0,1
16009,2014,MICHOACAN,ARIO,34.43526170798898,1,1,0,2
16013,2014,MICHOACAN,CARACUARO,43.421623968736434,2,0,0,2
16016,2014,MICHOACAN,COENEO,4.879953152449737,0,1,0,1
16017,2014,MICHOACAN,CONTEPEC,15.172664926867757,0,1,0,1
16019,2014,MICHOACAN,COTIJA,5.09061290979434,0,1,0,1
16020,2014,MICHOACAN,CUITZEO,14.170829347787578,1,2,0,3
16021,2014,MICHOACAN,CHARAPAN,0.0,1,3,0,4
16024,2014,MICHOACAN,CHERAN,0.0,0,1,0,1
16025,2014,MICHOACAN,CHILCHOTA,13.77676135893974,1,2,0,3
16028,2014,MICHOACAN,CHURINTZIO,17.972681524083395,1,2,0,3
16029,2014,MICHOACAN,CHURUMUCO,13.921759710427398,0,2,0,2
16030,2014,MICHOACAN,ECUANDUREO,38.895371450797356,1,3,1,5
16031,2014,MICHOACAN,EPITACIO HUERTA,0.0,1,0,0,1
16032,2014,MICHOACAN,ERONGARICUARO,41.22294744074202,0,0,1,1
16033,2014,MICHOACAN,GABRIEL ZAMORA,28.17695125387433,0,1,0,1
16034,2014,MICHOACAN,HIDALGO,13.603128719605511,3,0,0,3
16035,2014,MICHOACAN,LA HUACANA,30.52782611350246,0,2,0,2
16036,2014,MICHOACAN,HUANDACAREO,17.25327812284334,2,1,0,3
16037,2014,MICHOACAN,HUANIQUEO,75.15971439308531,1,0,0,1
16038,2014,MICHOACAN,HUETAMO,19.076233397715622,1,0,0,1
16040,2014,MICHOACAN,INDAPARAPEO,6.087538808059901,1,0,0,1
16042,2014,MICHOACAN,IXTLAN,7.3616018845700815,1,0,0,1
16045,2014,MICHOACAN,JIQUILPAN,38.012807392029,1,3,0,4
16046,2014,MICHOACAN,JUAREZ,0.0,1,0,0,1
16050,2014,MICHOACAN,MARAVATIO,11.213835380896608,2,0,0,2
16051,2014,MICHOACAN,MARCOS CASTELLANOS,7.674008134448623,1,0,0,1
16053,2014,MICHOACAN,MORELIA,24.95615532601378,2,3,3,8
16054,2014,MICHOACAN,MORELOS,0.0,0,1,0,1
16055,2014,MICHOACAN,MUGICA,24.46455974912706,2,0,0,2
16060,2014,MICHOACAN,NUMARAN,0.0,0,2,0,2
16062,2014,MICHOACAN,PAJACUARAN,35.98971722365038,3,2,0,5
16063,2014,MICHOACAN,PANINDICUARO,12.450199203187251,1,0,0,1
16064,2014,MICHOACAN,PARACUARO,31.56690210314485,0,3,0,3
16066,2014,MICHOACAN,PATZCUARO,19.36351003485432,0,1,0,1
16067,2014,MICHOACAN,PENJAMILLO,5.8278454455387845,0,2,0,2
16069,2014,MICHOACAN,LA PIEDAD,34.144773841086206,0,2,0,2
16070,2014,MICHOACAN,PUREPERO,6.5333856004181365,1,1,0,2
16072,2014,MICHOACAN,QUERENDARO,0.0,1,1,0,2
16073,2014,MICHOACAN,QUIROGA,19.537355423569867,1,1,0,2
16074,2014,MICHOACAN,COJUMATLAN DE REGULES,10.02004008016032,0,1,0,1
16076,2014,MICHOACAN,SAHUAYO,6.864266004036188,1,2,0,3
16078,2014,MICHOACAN,SANTA ANA MAYA,0.0,0,2,0,2
16082,2014,MICHOACAN,TACAMBARO,11.435923093417196,2,0,1,3
16083,2014,MICHOACAN,TANCITARO,30.597674576732167,0,2,0,2
16085,2014,MICHOACAN,TANGANCICUARO,18.3615386969428,1,0,0,1
16091,2014,MICHOACAN,TING?INDIN,22.20412996817408,0,1,0,1
16094,2014,MICHOACAN,TLAZAZALCA,43.54136429608128,2,0,0,2
16097,2014,MICHOACAN,TURICATO,12.548232267779277,2,2,0,4
16098,2014,MICHOACAN,TUXPAN,7.684623069238453,2,0,0,2
16100,2014,MICHOACAN,TZINTZUNTZAN,22.13042195337858,1,0,1,2
16101,2014,MICHOACAN,TZITZIO,32.7296530656775,1,4,0,5
16102,2014,MICHOACAN,URUAPAN,25.051530045980655,3,0,0,3
16103,2014,MICHOACAN,VENUSTIANO CARRANZA,38.368077759304256,1,0,0,1
16104,2014,MICHOACAN,VILLAMAR,17.656406332764405,2,0,0,2
16106,2014,MICHOACAN,YURECUARO,33.338889814969164,1,1,0,2
16107,2014,MICHOACAN,ZACAPU,5.445510856987271,0,1,0,1
16108,2014,MICHOACAN,ZAMORA,15.582852414267444,2,2,0,4
16110,2014,MICHOACAN,ZINAPECUARO,32.143316333090475,5,0,0,5
17002,2014,MORELOS,ATLATLAHUCAN,15.877216194760518,0,1,0,1
17005,2014,MORELOS,COATLAN DEL RIO,10.558547143912998,0,1,0,1
17006,2014,MORELOS,CUAUTLA,28.537672581574935,0,1,1,2
17010,2014,MORELOS,JANTETELCO,6.391409945033875,1,0,0,1
17011,2014,MORELOS,JIUTEPEC,19.29394322503338,1,0,0,1
17012,2014,MORELOS,JOJUTLA,38.10215004989567,1,0,0,1
17015,2014,MORELOS,MIACATLAN,36.01440576230492,0,1,0,1
17021,2014,MORELOS,TETECALA,120.9514850154549,1,0,1,2
17030,2014,MORELOS,YECAPIXTLA,14.954389113204725,0,2,0,2
17031,2014,MORELOS,ZACATEPEC,19.964064683569575,0,1,0,1
17032,2014,MORELOS,ZACUALPAN,0.0,0,2,0,2
18001,2014,NAYARIT,ACAPONETA,8.202996828174559,0,2,0,2
18005,2014,NAYARIT,HUAJICORI,52.63157894736842,2,1,0,3
18010,2014,NAYARIT,ROSAMORADA,2.907568400546623,0,6,0,6
18013,2014,NAYARIT,SAN PEDRO LAGUNILLAS,0.0,0,16,0,16
18014,2014,NAYARIT,SANTA MARIA DEL ORO,4.461895413171515,1,2,3,6
18015,2014,NAYARIT,SANTIAGO IXCUINTLA,5.372069536068074,0,6,0,6
18017,2014,NAYARIT,TEPIC,8.678523809398579,0,1,2,3
18018,2014,NAYARIT,TUXPAN,0.0,0,3,0,3
19004,2014,NUEVO LEON,ALLENDE,9.204430399165464,0,1,0,1
19015,2014,NUEVO LEON,DR. COSS,116.55011655011656,1,1,1,3
19020,2014,NUEVO LEON,GRAL. BRAVO,36.18599601954044,1,0,0,1
19022,2014,NUEVO LEON,GRAL. TERAN,0.0,1,0,0,1
19024,2014,NUEVO LEON,GRAL. ZARAGOZA,33.65870077415012,1,2,3,6
19027,2014,NUEVO LEON,LOS HERRERAS,0.0,0,1,0,1
19029,2014,NUEVO LEON,HUALAHUISES,14.46340757882557,0,0,1,1
19030,2014,NUEVO LEON,ITURBIDE,0.0,1,0,0,1
19032,2014,NUEVO LEON,LAMPAZOS DE NARANJO,0.0,1,1,0,2
19033,2014,NUEVO LEON,LINARES,8.898041159796108,0,0,1,1
19034,2014,NUEVO LEON,MARIN,36.44314868804665,3,0,0,3
19035,2014,NUEVO LEON,MELCHOR OCAMPO,0.0,0,1,0,1
19038,2014,NUEVO LEON,MONTEMORELOS,11.84172686211155,0,0,1,1
19040,2014,NUEVO LEON,PARAS,96.71179883945841,1,2,0,3
19044,2014,NUEVO LEON,SABINAS HIDALGO,20.189783969311527,2,1,1,4
19049,2014,NUEVO LEON,SANTIAGO,7.413081618028614,1,0,0,1
20026,2014,,,,1,0,0,1
20031,2014,,,,0,2,0,2
20041,2014,,,,0,1,0,1
20044,2014,,,,0,1,0,1
20133,2014,,,,1,0,0,1
20166,2014,,,,0,1,0,1
20222,2014,,,,0,1,0,1
20236,2014,,,,0,1,0,1
20269,2014,,,,0,9,0,9
20271,2014,,,,0,0,2,2
20298,2014,,,,1,0,0,1
20325,2014,,,,0,1,0,1
20372,2014,,,,1,0,0,1
20377,2014,,,,4,6,0,10
20378,2014,,,,1,0,0,1
20388,2014,,,,1,0,0,1
20447,2014,,,,0,1,0,1
20451,2014,,,,1,0,0,1
20461,2014,,,,0,1,0,1
20517,2014,,,,1,0,0,1
20559,2014,,,,1,0,0,1
21003,2014,PUEBLA,ACATLAN,17.717407352724052,0,0,1,1
21004,2014,PUEBLA,ACATZINGO,0.0,0,2,0,2
21015,2014,PUEBLA,AMOZOC,2.971356126936334,0,0,1,1
21022,2014,PUEBLA,ATZITZIHUACAN,17.117425539198905,1,0,1,2
21071,2014,PUEBLA,HUAUCHINANGO,6.1379190408478514,0,0,1,1
21085,2014,PUEBLA,IZUCAR DE MATAMOROS,13.73645242379703,0,2,0,2
21111,2014,PUEBLA,PANTEPEC,16.273393002441008,0,0,1,1
21113,2014,PUEBLA,PIAXTLA,43.62050163576881,1,1,0,2
21114,2014,PUEBLA,PUEBLA,3.2471348905293413,0,0,5,5
21118,2014,PUEBLA,LOS REYES DE JUAREZ,3.913434821743044,0,1,1,2
21120,2014,PUEBLA,SAN ANTONIO CA?ADA,0.0,0,3,0,3
21141,2014,PUEBLA,SAN PEDRO YELOIXTLAHUACA,29.455081001472752,0,1,0,1
21149,2014,PUEBLA,SANTIAGO MIAHUATLAN,4.546901286773064,0,1,0,1
21157,2014,PUEBLA,TEHUITZINGO,8.82768361581921,0,2,0,2
21164,2014,PUEBLA,TEPEACA,5.354178936660063,0,2,0,2
21166,2014,PUEBLA,TEPEOJUMA,24.826216484607745,0,1,1,2
21168,2014,PUEBLA,TEPEXCO,0.0,0,3,0,3
21203,2014,PUEBLA,XOCHITLAN TODOS SANTOS,16.531658125309967,0,0,1,1
21206,2014,PUEBLA,ZACAPALA,0.0,0,1,0,1
22001,2014,QUERETARO,AMEALCO DE BONFIL,3.2155891763268323,4,4,0,8
22002,2014,QUERETARO,PINAL DE AMOLES,3.69099029269553,0,3,0,3
22003,2014,QUERETARO,ARROYO SECO,7.745933384972888,0,3,0,3
22004,2014,QUERETARO,CADEREYTA DE MONTES,6.23217986071078,1,1,0,2
22005,2014,QUERETARO,COLON,3.4381392790221934,0,2,0,2
22008,2014,QUERETARO,HUIMILPAN,14.063115261292683,0,1,0,1
22009,2014,QUERETARO,JALPAN DE SERRA,3.913894324853229,0,5,0,5
22010,2014,QUERETARO,LANDA DE MATAMOROS,10.035626473982639,0,21,0,21
22012,2014,QUERETARO,PEDRO ESCOBEDO,3.1266610386767972,1,2,0,3
22013,2014,QUERETARO,PE?AMILLER,0.0,1,3,0,4
22014,2014,QUERETARO,QUERETARO,5.361997156894531,1,0,0,1
22015,2014,QUERETARO,SAN JOAQUIN,0.0,8,13,0,21
22016,2014,QUERETARO,SAN JUAN DEL RIO,2.896164237336522,1,0,0,1
22018,2014,QUERETARO,TOLIMAN,0.0,0,4,0,4
23001,2014,QUINTANA ROO,COZUMEL,5.029232413402904,1,2,0,3
23003,2014,QUINTANA ROO,ISLA MUJERES,12.343393198790348,1,0,0,1
24001,2014,SAN LUIS POTOSI,AHUALULCO,16.090967603518557,0,1,0,1
24004,2014,SAN LUIS POTOSI,ARMADILLO DE LOS INFANTE,0.0,0,1,0,1
24009,2014,SAN LUIS POTOSI,CERRO DE SAN PEDRO,0.0,0,2,0,2
24015,2014,SAN LUIS POTOSI,CHARCAS,0.0,0,1,0,1
24018,2014,SAN LUIS POTOSI,HUEHUETLAN,0.0,0,1,0,1
24025,2014,SAN LUIS POTOSI,SALINAS,0.0,0,2,0,2
24028,2014,SAN LUIS POTOSI,SAN LUIS POTOSI,15.40245714492806,2,0,0,2
24031,2014,SAN LUIS POTOSI,SANTA CATARINA,8.449514152936207,0,0,2,2
24033,2014,SAN LUIS POTOSI,SANTO DOMINGO,0.0,0,2,0,2
24035,2014,SAN LUIS POTOSI,SOLEDAD DE GRACIANO SANCHEZ,7.467172443146816,0,2,0,2
24046,2014,SAN LUIS POTOSI,VILLA DE ARRIAGA,18.386859524393234,0,1,0,1
24049,2014,SAN LUIS POTOSI,VILLA DE RAMOS,10.546298249314491,0,1,0,1
24056,2014,SAN LUIS POTOSI,VILLA DE ARISTA,12.879958784131892,0,1,0,1
24058,2014,SAN LUIS POTOSI,EL NARANJO,19.516955354964626,0,1,0,1
25001,2014,SINALOA,AHOME,29.065647527378157,0,3,2,5
25005,2014,SINALOA,COSALA,17.967299514882914,0,2,0,2
25007,2014,SINALOA,CHOIX,54.54876053094127,0,7,0,7
25008,2014,SINALOA,ELOTA,23.306220430232827,0,1,0,1
25011,2014,SINALOA,GUASAVE,22.03475195164946,0,3,0,3
25012,2014,SINALOA,MAZATLAN,17.106337555937724,0,4,0,4
26006,2014,SONORA,ARIZPE,0.0,0,1,0,1
26012,2014,SONORA,BACUM,74.49279172691818,0,1,0,1
26014,2014,SONORA,BAVIACORA,28.08988764044944,0,1,0,1
26015,2014,SONORA,BAVISPE,0.0,0,2,0,2
26028,2014,SONORA,GRANADOS,0.0,0,1,0,1
26030,2014,SONORA,HERMOSILLO,12.367054167697255,0,3,0,3
26031,2014,SONORA,HUACHINERA,0.0,0,2,0,2
26038,2014,SONORA,MOCTEZUMA,21.367521367521366,0,1,0,1
26048,2014,SONORA,PUERTO PE?ASCO,8.719612151651495,0,2,0,2
26049,2014,SONORA,QUIRIEGO,0.0,0,1,0,1
26051,2014,SONORA,ROSARIO,38.27018752391887,0,1,0,1
26061,2014,SONORA,SOYOPA,0.0,0,1,0,1
26063,2014,SONORA,TEPACHE,0.0,0,1,0,1
26069,2014,SONORA,YECORA,99.23916639100231,0,1,0,1
26072,2014,SONORA,SAN IGNACIO RIO MUERTO,63.6672325976231,0,1,0,1
28002,2014,TAMAULIPAS,ALDAMA,13.573125212080082,0,1,0,1
28003,2014,TAMAULIPAS,ALTAMIRA,13.679180758581328,0,4,0,4
28005,2014,TAMAULIPAS,BURGOS,0.0,0,1,0,1
28006,2014,TAMAULIPAS,BUSTAMANTE,0.0,0,1,0,1
28007,2014,TAMAULIPAS,CAMARGO,33.482890243085784,0,2,0,2
28010,2014,TAMAULIPAS,CRUILLAS,0.0,0,1,0,1
28011,2014,TAMAULIPAS,GOMEZ FARIAS,11.381743683132257,0,2,0,2
28012,2014,TAMAULIPAS,GONZALEZ,29.929780131230576,0,2,0,2
28013,2014,TAMAULIPAS,G?EMEZ,38.31662302829044,0,1,0,1
28014,2014,TAMAULIPAS,GUERRERO,67.00915791824883,0,1,0,1
28015,2014,TAMAULIPAS,GUSTAVO DIAZ ORDAZ,0.0,1,0,0,1
28016,2014,TAMAULIPAS,HIDALGO,58.84083553986466,0,1,0,1
28017,2014,TAMAULIPAS,JAUMAVE,13.240648791790798,0,1,0,1
28018,2014,TAMAULIPAS,JIMENEZ,11.993283761093787,0,2,0,2
28019,2014,TAMAULIPAS,LLERA,23.077366872439853,0,1,0,1
28020,2014,TAMAULIPAS,MAINERO,116.32415664986429,0,1,0,1
28021,2014,TAMAULIPAS,EL MANTE,12.090645295011745,0,3,0,3
28023,2014,TAMAULIPAS,MENDEZ,0.0,0,1,0,1
28024,2014,TAMAULIPAS,MIER,167.99664006719865,0,1,0,1
28025,2014,TAMAULIPAS,MIGUEL ALEMAN,62.92800296131779,0,1,0,1
28028,2014,TAMAULIPAS,NUEVO MORELOS,0.0,0,1,0,1
28031,2014,TAMAULIPAS,PALMILLAS,111.42061281337048,0,2,0,2
28032,2014,TAMAULIPAS,REYNOSA,11.824776519935423,0,1,0,1
28034,2014,TAMAULIPAS,SAN CARLOS,117.88661451077056,0,1,0,1
28035,2014,TAMAULIPAS,SAN FERNANDO,52.42922055225446,0,2,0,2
28039,2014,TAMAULIPAS,TULA,14.507471347744088,0,2,0,2
28040,2014,TAMAULIPAS,VALLE HERMOSO,15.830299192654742,0,2,0,2
28042,2014,TAMAULIPAS,VILLAGRAN,110.82963901203294,0,1,0,1
28043,2014,TAMAULIPAS,XICOTENCATL,13.12106368089573,0,1,0,1
29005,2014,TLAXCALA,APIZACO,6.536631281702662,0,3,0,3
29013,2014,TLAXCALA,HUAMANTLA,2.353522635003942,0,1,0,1
29014,2014,TLAXCALA,HUEYOTLIPAN,0.0,0,2,0,2
29019,2014,TLAXCALA,TEPETITLA DE LARDIZABAL,5.34045393858478,0,2,0,2
29025,2014,TLAXCALA,SAN PABLO DEL MONTE,1.4364720247073188,0,2,0,2
29028,2014,TLAXCALA,TEOLOCHOLCO,4.614461723040008,0,1,0,1
29033,2014,TLAXCALA,TLAXCALA,3.340943259646974,0,2,0,2
29039,2014,TLAXCALA,XALOZTOC,4.593688272313841,0,1,1,2
30007,2014,VERACRUZ,CAMARON DE TEJEDA,0.0,0,2,0,2
30008,2014,VERACRUZ,ALPATLAHUAC,0.0,0,1,0,1
30009,2014,VERACRUZ,ALTO LUCERO DE GUTIERREZ BARRIOS,0.0,0,1,3,4
30022,2014,VERACRUZ,ATZACAN,4.984299456711359,0,1,0,1
30029,2014,VERACRUZ,CALCAHUALCO,0.0,0,1,0,1
30039,2014,VERACRUZ,COATZACOALCOS,3.931075149053266,0,0,4,4
30085,2014,VERACRUZ,IXTACZOQUITLAN,1.5294027682190103,0,1,0,1
30087,2014,VERACRUZ,XALAPA,5.022623643891616,0,0,1,1
30101,2014,VERACRUZ,MARIANO ESCOBEDO,2.946289148817065,0,1,0,1
30105,2014,VERACRUZ,MEDELLIN,3.3826066366742213,0,1,0,1
30108,2014,VERACRUZ,MINATITLAN,5.701976685250887,0,0,1,1
30118,2014,VERACRUZ,ORIZABA,5.7853630315302285,0,0,2,2
30125,2014,VERACRUZ,PASO DEL MACHO,17.143836790673753,0,3,0,3
30134,2014,VERACRUZ,PUENTE NACIONAL,4.6289867148081285,0,1,0,1
30135,2014,VERACRUZ,RAFAEL DELGADO,9.878982464806125,0,2,0,2
30138,2014,VERACRUZ,RIO BLANCO,2.460993256878476,0,1,0,1
30187,2014,VERACRUZ,TONAYAN,0.0,0,2,0,2
30191,2014,VERACRUZ,URSULO GALVAN,0.0,0,2,0,2
30199,2014,VERACRUZ,ZARAGOZA,0.0,0,1,0,1
31009,2014,YUCATAN,CANSAHCAB,0.0,1,0,0,1
31010,2014,YUCATAN,CANTAMAYEC,0.0,0,1,0,1
31012,2014,YUCATAN,CENOTILLO,0.0,0,1,0,1
31016,2014,YUCATAN,CHACSINKIN,0.0,0,0,1,1
31019,2014,YUCATAN,CHEMAX,0.0,0,1,0,1
31021,2014,YUCATAN,CHICHIMILA,0.0,0,1,0,1
31032,2014,YUCATAN,ESPITA,0.0,0,0,1,1
31034,2014,YUCATAN,HOCABA,0.0,0,1,0,1
31035,2014,YUCATAN,HOCTUN,0.0,0,1,0,1
31036,2014,YUCATAN,HOMUN,0.0,0,1,2,3
31038,2014,YUCATAN,HUNUCMA,3.254043148612151,1,0,0,1
31041,2014,YUCATAN,KANASIN,3.811508213800201,0,1,0,1
31046,2014,YUCATAN,MAMA,0.0,0,1,0,1
31049,2014,YUCATAN,MAYAPAN,0.0,0,1,0,1
31050,2014,YUCATAN,MERIDA,2.2871395347717436,0,0,2,2
31052,2014,YUCATAN,MOTUL,2.9430808169992346,0,0,1,1
31054,2014,YUCATAN,MUXUPIP,0.0,0,1,0,1
31056,2014,YUCATAN,OXKUTZCAB,0.0,0,1,4,5
31060,2014,YUCATAN,QUINTANA ROO,0.0,0,1,0,1
31063,2014,YUCATAN,SAMAHIL,0.0,0,2,0,2
31073,2014,YUCATAN,TAHDZIU,0.0,1,0,1,2
31079,2014,YUCATAN,TEKAX,27.1290107776161,0,1,0,1
31080,2014,YUCATAN,TEKIT,0.0,0,1,0,1
31081,2014,YUCATAN,TEKOM,0.0,0,1,0,1
31083,2014,YUCATAN,TELCHAC PUERTO,0.0,0,0,1,1
31092,2014,YUCATAN,TIXCACALCUPUL,0.0,0,1,0,1
31096,2014,YUCATAN,TIZIMIN,1.3672782958243321,0,1,0,1
31098,2014,YUCATAN,TZUCACAB,0.0,1,0,2,3
31099,2014,YUCATAN,UAYMA,0.0,0,1,0,1
31102,2014,YUCATAN,VALLADOLID,0.0,0,4,0,4
32001,2014,ZACATECAS,APOZOL,0.0,1,0,0,1
32002,2014,ZACATECAS,APULCO,0.0,0,0,1,1
32003,2014,ZACATECAS,ATOLINGA,0.0,2,6,0,8
32004,2014,ZACATECAS,BENITO JUAREZ,0.0,1,4,0,5
32009,2014,ZACATECAS,CHALCHIHUITES,9.46521533364884,2,0,0,2
32010,2014,ZACATECAS,FRESNILLO,15.952031303515547,7,3,2,12
32014,2014,ZACATECAS,GENERAL FRANCISCO R. MURGUIA,0.0,0,1,0,1
32015,2014,ZACATECAS,EL PLATEADO DE JOAQUIN AMARO,0.0,2,0,0,2
32016,2014,ZACATECAS,GENERAL PANFILO NATERA,0.0,0,1,0,1
32017,2014,ZACATECAS,GUADALUPE,1.2500703164553006,5,5,1,11
32019,2014,ZACATECAS,JALPA,16.980090843486014,1,19,0,20
32022,2014,ZACATECAS,JUAN ALDAMA,4.867838193058463,1,7,0,8
32023,2014,ZACATECAS,JUCHIPILA,24.4220123738196,3,6,0,9
32024,2014,ZACATECAS,LORETO,2.0676108756332057,0,5,0,5
32025,2014,ZACATECAS,LUIS MOYA,0.0,0,4,0,4
32030,2014,ZACATECAS,MOMAX,0.0,4,2,0,6
32031,2014,ZACATECAS,MONTE ESCOBEDO,0.0,2,0,0,2
32032,2014,ZACATECAS,MORELOS,0.0,1,2,0,3
32033,2014,ZACATECAS,MOYAHUA DE ESTRADA,0.0,1,0,1,2
32034,2014,ZACATECAS,NOCHISTLAN DE MEJIA,17.900615781182875,6,10,0,16
32036,2014,ZACATECAS,OJOCALIENTE,12.272950417280313,0,2,0,2
32037,2014,ZACATECAS,PANUCO,0.0,0,3,6,9
32038,2014,ZACATECAS,PINOS,11.45409770345341,0,7,0,7
32039,2014,ZACATECAS,RIO GRANDE,4.785223230663711,1,2,0,3
32040,2014,ZACATECAS,SAIN ALTO,9.288069474759672,1,1,0,2
32042,2014,ZACATECAS,SOMBRERETE,16.343073805321307,1,1,0,2
32043,2014,ZACATECAS,SUSTICACAN,0.0,0,1,0,1
32045,2014,ZACATECAS,TEPECHITLAN,0.0,2,5,0,7
32046,2014,ZACATECAS,TEPETONGO,0.0,2,5,0,7
32048,2014,ZACATECAS,TLALTENANGO DE SANCHEZ ROMAN,3.922645432079394,2,1,0,3
32049,2014,ZACATECAS,VALPARAISO,30.009302883894005,19,4,1,24
32050,2014,ZACATECAS,VETAGRANDE,0.0,0,6,0,6
32051,2014,ZACATECAS,VILLA DE COS,0.0,1,2,0,3
32052,2014,ZACATECAS,VILLA GARCIA,0.0,0,0,1,1
32055,2014,ZACATECAS,VILLANUEVA,6.803878210580031,5,5,0,10
32056,2014,ZACATECAS,ZACATECAS,2.1711440481704494,0,0,3,3
