,id,year,ENTIDAD,MUNICIPIO,hom_rate,Servicios Comunitarios,Infraestructura,Proyectos Productivos,Total 3x1
0,1001,2013,AGUASCALIENTES,AGUASCALIENTES,2.3839098631133857,2,4,0,6
1,1002,2013,AGUASCALIENTES,ASIENTOS,10.990943462586827,1,1,0,2
2,1003,2013,AGUASCALIENTES,CALVILLO,0.0,2,11,4,17
3,1004,2013,AGUASCALIENTES,COSIO,0.0,1,1,0,2
4,1006,2013,AGUASCALIENTES,PABELLON DE ARTEAGA,2.388801299507907,1,0,0,1
5,1007,2013,AGUASCALIENTES,RINCON DE ROMOS,4.068679306697046,1,1,0,2
6,1008,2013,AGUASCALIENTES,SAN JOSE DE GRACIA,0.0,1,3,0,4
7,1009,2013,AGUASCALIENTES,TEPEZALA,0.0,1,0,0,1
8,2001,2013,BAJA CALIFORNIA,ENSENADA,10.28246796368575,0,0,1,1
9,2004,2013,BAJA CALIFORNIA,TIJUANA,31.54487161814292,12,3,2,17
10,4001,2013,CAMPECHE,CALKINI,1.890716581584421,0,1,0,1
11,4002,2013,CAMPECHE,CAMPECHE,4.247022258257562,0,0,1,1
12,4003,2013,CAMPECHE,CARMEN,11.307407708938278,0,0,3,3
13,4004,2013,CAMPECHE,CHAMPOTON,7.227087122535262,1,0,1,2
14,4009,2013,CAMPECHE,ESCARCEGA,18.45563265908756,1,0,2,3
15,4010,2013,CAMPECHE,CALAKMUL,7.4399226248047015,0,1,0,1
16,4011,2013,CAMPECHE,CANDELARIA,24.275379909695587,1,0,1,2
17,6002,2013,COLIMA,COLIMA,26.547949681424605,0,6,0,6
18,6003,2013,COLIMA,COMALA,0.0,0,5,0,5
19,6004,2013,COLIMA,COQUIMATLAN,20.63451122001548,0,5,0,5
20,6005,2013,COLIMA,CUAUHTEMOC,22.13450400265614,0,15,0,15
21,6006,2013,COLIMA,IXTLAHUACAN,37.735849056603776,0,7,0,7
22,6007,2013,COLIMA,MANZANILLO,33.45310370462148,0,28,0,28
23,6008,2013,COLIMA,MINATITLAN,12.233912405187178,0,4,0,4
24,6009,2013,COLIMA,TECOMAN,39.91980554619165,0,5,0,5
25,7006,2013,CHIAPAS,AMATENANGO DE LA FRONTERA,6.768876704910821,0,1,0,1
26,7031,2013,CHIAPAS,CHILON,10.7571221112645,0,12,0,12
27,7075,2013,CHIAPAS,LAS ROSAS,0.0,0,2,0,2
28,7093,2013,CHIAPAS,TENEJAPA,2.483361478096752,0,1,0,1
29,7106,2013,CHIAPAS,VENUSTIANO CARRANZA,24.45346505599843,0,1,0,1
30,8006,2013,CHIHUAHUA,BACHINIVA,0.0,0,1,0,1
31,8009,2013,CHIHUAHUA,BOCOYNA,83.43182924285615,0,1,0,1
32,8010,2013,CHIHUAHUA,BUENAVENTURA,13.406023773348824,0,1,0,1
33,8012,2013,CHIHUAHUA,CARICHI,34.110289937464465,0,1,0,1
34,8014,2013,CHIHUAHUA,CORONADO,43.78283712784589,0,0,1,1
35,8017,2013,CHIHUAHUA,CUAUHTEMOC,20.69335678580436,0,1,0,1
36,8018,2013,CHIHUAHUA,CUSIHUIRIACHI,73.88252678241595,0,1,0,1
37,8019,2013,CHIHUAHUA,CHIHUAHUA,30.62682495000262,0,0,1,1
38,8021,2013,CHIHUAHUA,DELICIAS,31.89908290136659,0,1,0,1
39,8022,2013,CHIHUAHUA,DR. BELISARIO DOMINGUEZ,0.0,0,2,0,2
40,8024,2013,CHIHUAHUA,SANTA ISABEL,50.80010160020319,0,1,1,2
41,8025,2013,CHIHUAHUA,GOMEZ FARIAS,11.595547309833027,0,1,0,1
42,8026,2013,CHIHUAHUA,GRAN MORELOS,373.94827048924896,0,1,0,1
43,8031,2013,CHIHUAHUA,GUERRERO,22.71236057134205,0,1,1,2
44,8036,2013,CHIHUAHUA,JIMENEZ,118.74469889737064,0,1,0,1
45,8039,2013,CHIHUAHUA,LOPEZ,74.53416149068323,0,0,2,2
46,8040,2013,CHIHUAHUA,MADERA,33.77123366316572,0,1,1,2
47,8045,2013,CHIHUAHUA,MEOQUI,50.19049574521479,0,0,1,1
48,8047,2013,CHIHUAHUA,MORIS,150.60240963855424,0,1,0,1
49,8048,2013,CHIHUAHUA,NAMIQUIPA,17.482517482517483,0,4,1,5
50,8050,2013,CHIHUAHUA,NUEVO CASAS GRANDES,6.741156445388207,0,1,0,1
51,8051,2013,CHIHUAHUA,OCAMPO,145.7725947521866,0,1,0,1
52,8052,2013,CHIHUAHUA,OJINAGA,22.810218978102192,0,2,0,2
53,8054,2013,CHIHUAHUA,RIVA PALACIO,49.92511233150275,0,1,0,1
54,8055,2013,CHIHUAHUA,ROSALES,77.45010425975573,0,1,0,1
55,8057,2013,CHIHUAHUA,SAN FRANCISCO DE BORJA,0.0,0,0,1,1
56,8061,2013,CHIHUAHUA,SATEVO,54.61496450027307,0,1,0,1
57,8063,2013,CHIHUAHUA,TEMOSACHIC,80.50233456770246,0,1,0,1
58,8065,2013,CHIHUAHUA,URIQUE,156.97046993034436,0,2,0,2
59,10002,2013,DURANGO,CANELAS,0.0,0,3,0,3
60,10004,2013,DURANGO,CUENCAME,17.823193916349812,0,0,1,1
61,10005,2013,DURANGO,DURANGO,14.082886373433494,1,0,8,9
62,10008,2013,DURANGO,GUADALUPE VICTORIA,11.74674027957242,0,2,0,2
63,10010,2013,DURANGO,HIDALGO,0.0,0,5,0,5
64,10011,2013,DURANGO,INDE,0.0,0,4,0,4
65,10012,2013,DURANGO,LERDO,42.540218231319535,0,0,1,1
66,10013,2013,DURANGO,MAPIMI,3.978199466921272,0,1,0,1
67,10015,2013,DURANGO,NAZAS,16.11473692691967,0,3,0,3
68,10016,2013,DURANGO,NOMBRE DE DIOS,10.817827780181739,0,1,4,5
69,10018,2013,DURANGO,EL ORO,132.50883392226152,0,2,0,2
70,10020,2013,DURANGO,PANUCO DE CORONADO,0.0,0,9,0,9
71,10021,2013,DURANGO,PE?ON BLANCO,0.0,0,1,1,2
72,10022,2013,DURANGO,POANAS,8.026326350429407,0,6,0,6
73,10023,2013,DURANGO,PUEBLO NUEVO,44.75001017045686,0,0,1,1
74,10024,2013,DURANGO,RODEO,7.819831091648421,0,2,0,2
75,10025,2013,DURANGO,SAN BERNARDO,0.0,0,1,0,1
76,10028,2013,DURANGO,SAN JUAN DEL RIO,42.176296921130316,1,2,0,3
77,10029,2013,DURANGO,SAN LUIS DEL CORDERO,0.0,0,6,0,6
78,10030,2013,DURANGO,SAN PEDRO DEL GALLO,0.0,0,2,0,2
79,10031,2013,DURANGO,SANTA CLARA,0.0,0,2,0,2
80,10033,2013,DURANGO,SUCHIL,0.0,0,0,2,2
81,10034,2013,DURANGO,TAMAZULA,83.43446601941747,0,3,0,3
82,10035,2013,DURANGO,TEPEHUANES,46.53327128897161,1,10,0,11
83,10036,2013,DURANGO,TLAHUALILO,26.9735659054127,0,18,4,22
84,10037,2013,DURANGO,TOPIA,11.653653420347277,0,6,2,8
85,10038,2013,DURANGO,VICENTE GUERRERO,23.67760572050954,0,5,1,6
86,10039,2013,DURANGO,NUEVO IDEAL,30.660738923808065,0,3,0,3
87,11001,2013,GUANAJUATO,ABASOLO,7.1147369918892,0,5,4,9
88,11003,2013,GUANAJUATO,SAN MIGUEL DE ALLENDE,11.846642100471994,0,0,1,1
89,11004,2013,GUANAJUATO,APASEO EL ALTO,10.863998261760278,0,8,0,8
90,11005,2013,GUANAJUATO,APASEO EL GRANDE,14.064862457365885,0,1,0,1
91,11008,2013,GUANAJUATO,MANUEL DOBLADO,10.768609503297887,0,0,1,1
92,11010,2013,GUANAJUATO,CORONEO,8.553588230262596,0,15,0,15
93,11011,2013,GUANAJUATO,CORTAZAR,9.05008088509791,0,2,0,2
94,11012,2013,GUANAJUATO,CUERAMARO,14.647722279185588,0,5,0,5
95,11013,2013,GUANAJUATO,DOCTOR MORA,8.574858514834505,0,13,0,13
96,11015,2013,GUANAJUATO,GUANAJUATO,5.82380655644142,0,4,1,5
97,11016,2013,GUANAJUATO,HUANIMARO,0.0,0,1,2,3
98,11017,2013,GUANAJUATO,IRAPUATO,9.632819582955577,0,0,5,5
99,11018,2013,GUANAJUATO,JARAL DEL PROGRESO,0.0,0,3,0,3
100,11019,2013,GUANAJUATO,JERECUARO,15.738117721120556,0,2,0,2
101,11020,2013,GUANAJUATO,LEON,11.625640454444197,0,3,12,15
102,11021,2013,GUANAJUATO,MOROLEON,4.051535531966615,0,2,0,2
103,11022,2013,GUANAJUATO,OCAMPO,0.0,0,13,1,14
104,11024,2013,GUANAJUATO,PUEBLO NUEVO,17.906706061420003,0,0,2,2
105,11025,2013,GUANAJUATO,PURISIMA DEL RINCON,14.53594011192674,0,2,0,2
106,11027,2013,GUANAJUATO,SALAMANCA,9.58838961078809,0,2,0,2
107,11028,2013,GUANAJUATO,SALVATIERRA,18.54637624415274,0,7,1,8
108,11030,2013,GUANAJUATO,SAN FELIPE,13.089984292018853,0,13,1,14
109,11031,2013,GUANAJUATO,SAN FRANCISCO DEL RINCON,14.088227524874526,0,3,1,4
110,11032,2013,GUANAJUATO,SAN JOSE ITURBIDE,11.048045186504812,0,18,0,18
111,11035,2013,GUANAJUATO,SANTA CRUZ DE JUVENTINO ROSAS,20.198449768980232,0,6,0,6
112,11039,2013,GUANAJUATO,TARIMORO,16.867673104495235,0,8,0,8
113,11041,2013,GUANAJUATO,URIANGATO,11.803389258915772,0,8,0,8
114,11044,2013,GUANAJUATO,VILLAGRAN,14.341543867197304,0,7,4,11
115,11046,2013,GUANAJUATO,YURIRIA,11.302308496510413,0,7,0,7
116,12006,2013,GUERRERO,APAXTLA,96.86011784647673,0,1,0,1
117,12011,2013,GUERRERO,ATOYAC DE ALVAREZ,97.85374127470809,4,2,1,7
118,12012,2013,GUERRERO,AYUTLA DE LOS LIBRES,27.11756260966661,0,1,2,3
119,12014,2013,GUERRERO,BENITO JUAREZ,0.0,2,1,0,3
120,12015,2013,GUERRERO,BUENAVISTA DE CUELLAR,0.0,0,3,0,3
121,12016,2013,GUERRERO,COAHUAYUTLA DE JOSE MARIA IZAZAGA,15.355086372360844,0,1,0,1
122,12017,2013,GUERRERO,COCULA,20.39844971782145,2,8,0,10
123,12018,2013,GUERRERO,COPALA,7.333528894103843,1,2,0,3
124,12021,2013,GUERRERO,COYUCA DE BENITEZ,144.2962156275524,1,0,0,1
125,12022,2013,GUERRERO,COYUCA DE CATALAN,159.2621645392094,0,0,3,3
126,12023,2013,GUERRERO,CUAJINICUILAPA,69.43908649023993,1,0,0,1
127,12026,2013,GUERRERO,CUETZALA DEL PROGRESO,10.909884355225834,0,1,0,1
128,12028,2013,GUERRERO,CHILAPA DE ALVAREZ,38.08262273367001,0,5,0,5
129,12029,2013,GUERRERO,CHILPANCINGO DE LOS BRAVO,67.84793787776616,1,1,1,3
130,12030,2013,GUERRERO,FLORENCIO VILLARREAL,24.78314745972739,1,2,1,4
131,12031,2013,GUERRERO,GENERAL CANUTO A. NERI,31.740993493096326,0,1,0,1
132,12032,2013,GUERRERO,GENERAL HELIODORO CASTILLO,43.732575302028096,0,1,1,2
133,12033,2013,GUERRERO,HUAMUXTITLAN,20.84346557354269,0,1,0,1
134,12034,2013,GUERRERO,HUITZUCO DE LOS FIGUEROA,16.058237876030404,0,2,0,2
135,12035,2013,GUERRERO,IGUALA DE LA INDEPENDENCIA,76.23091555466897,0,8,0,8
136,12037,2013,GUERRERO,IXCATEOPAN DE CUAUHTEMOC,15.144631228229592,0,3,0,3
137,12042,2013,GUERRERO,MARTIR DE CUILAPAN,0.0,0,1,0,1
138,12045,2013,GUERRERO,OLINALA,8.089633135137321,1,0,0,1
139,12046,2013,GUERRERO,OMETEPEC,79.92692395524092,0,0,1,1
140,12049,2013,GUERRERO,PILCAYA,51.91209551825575,1,2,0,3
141,12055,2013,GUERRERO,TAXCO DE ALARCON,24.98726610477352,1,27,0,28
142,12059,2013,GUERRERO,TEPECOACUILCO DE TRUJANO,13.127666557269444,0,1,0,1
143,12060,2013,GUERRERO,TETIPAC,7.617306520414382,0,5,0,5
144,12061,2013,GUERRERO,TIXTLA DE GUERRERO,32.452943232313146,0,0,1,1
145,12068,2013,GUERRERO,LA UNION DE ISIDORO MONTES DE OCA,124.45550715619166,0,1,0,1
146,12073,2013,GUERRERO,ZIRANDARO,10.630946685802373,0,0,2,2
147,12075,2013,GUERRERO,EDUARDO NERI,10.832358421075435,0,1,0,1
148,12080,2013,GUERRERO,JUCHITAN,55.81914596706671,0,1,0,1
149,13001,2013,HIDALGO,ACATLAN,4.980823828261196,0,1,0,1
150,13003,2013,HIDALGO,ACTOPAN,11.049927254645574,1,4,0,5
151,13006,2013,HIDALGO,ALFAJAYUCAN,0.0,0,4,0,4
152,13009,2013,HIDALGO,EL ARENAL,11.511453896627145,0,8,0,8
153,13012,2013,HIDALGO,ATOTONILCO EL GRANDE,3.7119524870081664,0,3,0,3
154,13015,2013,HIDALGO,CARDONAL,0.0,1,2,0,3
155,13018,2013,HIDALGO,CHAPULHUACAN,4.463887152932773,0,1,0,1
156,13019,2013,HIDALGO,CHILCUAUTLA,5.7352603808212885,0,3,1,4
157,13022,2013,HIDALGO,EPAZOYUCAN,0.0,0,3,0,3
158,13024,2013,HIDALGO,HUASCA DE OCAMPO,5.820044232336166,0,0,1,1
159,13030,2013,HIDALGO,IXMIQUILPAN,3.473709806282783,1,4,2,7
160,13031,2013,HIDALGO,JACALA DE LEDEZMA,15.620118712902215,0,1,0,1
161,13036,2013,HIDALGO,SAN AGUSTIN METZQUITITLAN,21.358393848782576,0,2,0,2
162,13037,2013,HIDALGO,METZTITLAN,4.624705175045091,0,3,0,3
163,13038,2013,HIDALGO,MINERAL DEL CHICO,0.0,0,1,0,1
164,13040,2013,HIDALGO,LA MISION,0.0,0,1,0,1
165,13041,2013,HIDALGO,MIXQUIAHUALA DE JUAREZ,0.0,0,3,0,3
166,13042,2013,HIDALGO,MOLANGO DE ESCAMILLA,26.76420733339281,0,1,0,1
167,13043,2013,HIDALGO,NICOLAS FLORES,0.0,0,1,0,1
168,13045,2013,HIDALGO,OMITLAN DE JUAREZ,0.0,0,4,0,4
169,13048,2013,HIDALGO,PACHUCA DE SOTO,5.226571891496367,0,3,2,5
170,13054,2013,HIDALGO,SAN SALVADOR,6.10258444451225,0,5,1,6
171,13055,2013,HIDALGO,SANTIAGO DE ANAYA,6.244536030972898,0,3,0,3
172,13056,2013,HIDALGO,SANTIAGO TULANTEPEC DE LUGO GUERRERO,0.0,0,5,0,5
173,13058,2013,HIDALGO,TASQUILLO,0.0,2,7,0,9
174,13066,2013,HIDALGO,VILLA DE TEZONTEPEC,0.0,0,2,0,2
175,13070,2013,HIDALGO,TLAHUELILPAN,17.489651955926078,0,2,0,2
176,13075,2013,HIDALGO,TOLCAYUCA,0.0,0,1,0,1
177,14001,2013,JALISCO,ACATIC,0.0,0,7,0,7
178,14003,2013,JALISCO,AHUALULCO DE MERCADO,0.0,0,4,0,4
179,14004,2013,JALISCO,AMACUECA,0.0,0,3,0,3
180,14005,2013,JALISCO,AMATITAN,0.0,0,5,0,5
181,14006,2013,JALISCO,AMECA,0.0,1,0,1,2
182,14007,2013,JALISCO,SAN JUANITO DE ESCOBEDO,0.0,0,4,0,4
183,14010,2013,JALISCO,ATEMAJAC DE BRIZUELA,0.0,1,2,0,3
184,14011,2013,JALISCO,ATENGO,0.0,0,2,0,2
185,14013,2013,JALISCO,ATOTONILCO EL ALTO,0.0,0,2,0,2
186,14014,2013,JALISCO,ATOYAC,0.0,0,6,0,6
187,14015,2013,JALISCO,AUTLAN DE NAVARRO,0.0,1,3,0,4
188,14016,2013,JALISCO,AYOTLAN,0.0,0,10,0,10
189,14017,2013,JALISCO,AYUTLA,0.0,0,9,0,9
190,14018,2013,JALISCO,LA BARCA,0.0,0,2,0,2
191,14019,2013,JALISCO,BOLA?OS,0.0,0,1,0,1
192,14020,2013,JALISCO,CABO CORRIENTES,0.0,1,1,0,2
193,14021,2013,JALISCO,CASIMIRO CASTILLO,0.0,0,3,0,3
194,14023,2013,JALISCO,ZAPOTLAN EL GRANDE,6.962818548948616,0,5,0,5
195,14025,2013,JALISCO,COLOTLAN,0.0,0,6,0,6
196,14026,2013,JALISCO,CONCEPCION DE BUENOS AIRES,0.0,0,3,0,3
197,14027,2013,JALISCO,CUAUTITLAN DE GARCIA BARRAGAN,0.0,1,5,0,6
198,14028,2013,JALISCO,CUAUTLA,0.0,1,2,0,3
199,14029,2013,JALISCO,CUQUIO,0.0,0,11,0,11
200,14030,2013,JALISCO,CHAPALA,0.0,0,2,0,2
201,14032,2013,JALISCO,CHIQUILISTLAN,0.0,1,0,0,1
202,14033,2013,JALISCO,DEGOLLADO,0.0,0,2,0,2
203,14034,2013,JALISCO,EJUTLA,0.0,0,2,0,2
204,14035,2013,JALISCO,ENCARNACION DE DIAZ,0.0,0,3,0,3
205,14036,2013,JALISCO,ETZATLAN,0.0,0,3,0,3
206,14037,2013,JALISCO,EL GRULLO,0.0,1,0,0,1
207,14038,2013,JALISCO,GUACHINANGO,0.0,1,0,0,1
208,14039,2013,JALISCO,GUADALAJARA,10.500344772466892,0,7,7,14
209,14040,2013,JALISCO,HOSTOTIPAQUILLO,0.0,0,2,0,2
210,14042,2013,JALISCO,HUEJUQUILLA EL ALTO,0.0,0,1,0,1
211,14043,2013,JALISCO,LA HUERTA,0.0,0,3,0,3
212,14045,2013,JALISCO,IXTLAHUACAN DEL RIO,0.0,0,1,0,1
213,14046,2013,JALISCO,JALOSTOTITLAN,0.0,0,4,0,4
214,14048,2013,JALISCO,JESUS MARIA,0.0,0,4,0,4
215,14049,2013,JALISCO,JILOTLAN DE LOS DOLORES,0.0,0,4,0,4
216,14050,2013,JALISCO,JOCOTEPEC,0.0,0,3,0,3
217,14051,2013,JALISCO,JUANACATLAN,0.0,0,1,0,1
218,14052,2013,JALISCO,JUCHITLAN,0.0,0,4,0,4
219,14053,2013,JALISCO,LAGOS DE MORENO,7.801478380153038,1,1,0,2
220,14055,2013,JALISCO,MAGDALENA,0.0,0,2,1,3
221,14056,2013,JALISCO,SANTA MARIA DEL ORO,0.0,0,3,0,3
222,14058,2013,JALISCO,MASCOTA,0.0,1,2,0,3
223,14059,2013,JALISCO,MAZAMITLA,0.0,0,1,0,1
224,14060,2013,JALISCO,MEXTICACAN,0.0,0,10,0,10
225,14062,2013,JALISCO,MIXTLAN,0.0,0,2,0,2
226,14063,2013,JALISCO,OCOTLAN,25.815611991351773,1,5,0,6
227,14064,2013,JALISCO,OJUELOS DE JALISCO,0.0,1,0,0,1
228,14065,2013,JALISCO,PIHUAMO,0.0,0,1,0,1
229,14066,2013,JALISCO,PONCITLAN,0.0,2,0,0,2
230,14067,2013,JALISCO,PUERTO VALLARTA,13.68893269347351,0,1,0,1
231,14068,2013,JALISCO,VILLA PURIFICACION,0.0,0,3,0,3
232,14069,2013,JALISCO,QUITUPAN,0.0,0,7,0,7
233,14070,2013,JALISCO,EL SALTO,39.0664563830249,2,0,1,3
234,14071,2013,JALISCO,SAN CRISTOBAL DE LA BARRANCA,0.0,0,2,0,2
235,14072,2013,JALISCO,SAN DIEGO DE ALEJANDRIA,0.0,0,10,0,10
236,14074,2013,JALISCO,SAN JULIAN,0.0,0,2,0,2
237,14075,2013,JALISCO,SAN MARCOS,0.0,0,2,0,2
238,14076,2013,JALISCO,SAN MARTIN DE BOLA?OS,0.0,0,4,0,4
239,14077,2013,JALISCO,SAN MARTIN HIDALGO,0.0,0,5,0,5
240,14078,2013,JALISCO,SAN MIGUEL EL ALTO,0.0,0,9,0,9
241,14079,2013,JALISCO,GOMEZ FARIAS,0.0,0,1,1,2
242,14081,2013,JALISCO,SANTA MARIA DE LOS ANGELES,0.0,0,3,0,3
243,14082,2013,JALISCO,SAYULA,0.0,0,2,0,2
244,14083,2013,JALISCO,TALA,0.0,0,24,0,24
245,14084,2013,JALISCO,TALPA DE ALLENDE,0.0,0,2,0,2
246,14085,2013,JALISCO,TAMAZULA DE GORDIANO,0.0,0,2,0,2
247,14086,2013,JALISCO,TAPALPA,0.0,0,3,0,3
248,14088,2013,JALISCO,TECOLOTLAN,0.0,0,14,0,14
249,14091,2013,JALISCO,TEOCALTICHE,0.0,0,1,0,1
250,14092,2013,JALISCO,TEOCUITATLAN DE CORONA,0.0,0,1,1,2
251,14094,2013,JALISCO,TEQUILA,0.0,0,2,0,2
252,14095,2013,JALISCO,TEUCHITLAN,0.0,0,5,0,5
253,14096,2013,JALISCO,TIZAPAN EL ALTO,0.0,0,1,0,1
254,14097,2013,JALISCO,TLAJOMULCO DE ZU?IGA,15.121475856043551,0,0,3,3
255,14098,2013,JALISCO,TLAQUEPAQUE,17.102056522296806,0,0,1,1
256,14099,2013,JALISCO,TOLIMAN,0.0,0,1,0,1
257,14101,2013,JALISCO,TONALA,14.623273148119134,3,5,3,11
258,14102,2013,JALISCO,TONAYA,0.0,0,22,0,22
259,14104,2013,JALISCO,TOTATICHE,0.0,0,3,0,3
260,14106,2013,JALISCO,TUXCACUESCO,0.0,1,3,0,4
261,14107,2013,JALISCO,TUXCUECA,0.0,1,2,1,4
262,14108,2013,JALISCO,TUXPAN,0.0,1,1,0,2
263,14109,2013,JALISCO,UNION DE SAN ANTONIO,0.0,0,11,0,11
264,14111,2013,JALISCO,VALLE DE GUADALUPE,0.0,1,6,0,7
265,14112,2013,JALISCO,VALLE DE JUAREZ,0.0,0,4,0,4
266,14113,2013,JALISCO,SAN GABRIEL,0.0,0,3,0,3
267,14115,2013,JALISCO,VILLA GUERRERO,0.0,0,6,0,6
268,14116,2013,JALISCO,VILLA HIDALGO,0.0,0,10,0,10
269,14117,2013,JALISCO,CA?ADAS DE OBREGON,0.0,1,9,0,10
270,14118,2013,JALISCO,YAHUALICA DE GONZALEZ GALLO,0.0,0,15,1,16
271,14119,2013,JALISCO,ZACOALCO DE TORRES,0.0,0,8,0,8
272,14120,2013,JALISCO,ZAPOPAN,17.447152013739032,0,0,1,1
273,14121,2013,JALISCO,ZAPOTILTIC,0.0,0,2,0,2
274,14122,2013,JALISCO,ZAPOTITLAN DE VADILLO,0.0,0,6,0,6
275,14123,2013,JALISCO,ZAPOTLAN DEL REY,0.0,0,5,0,5
276,14124,2013,JALISCO,ZAPOTLANEJO,0.0,0,4,0,4
277,14125,2013,JALISCO,SAN IGNACIO CERRO GORDO,0.0,0,9,0,9
278,15016,2013,MEXICO,AXAPUSCO,3.9125161391290737,0,1,0,1
279,15019,2013,MEXICO,CAPULHUAC,8.797395970792646,0,1,0,1
280,15021,2013,MEXICO,COATEPEC HARINAS,0.0,0,0,1,1
281,15041,2013,MEXICO,IXTAPAN DEL ORO,0.0,1,0,0,1
282,15042,2013,MEXICO,IXTLAHUACA,9.895251692794842,0,0,1,1
283,15047,2013,MEXICO,JIQUIPILCO,2.897249062015616,0,1,1,2
284,15048,2013,MEXICO,JOCOTITLAN,1.633880138553036,0,1,0,1
285,15052,2013,MEXICO,MALINALCO,7.805182641273806,0,1,0,1
286,15056,2013,MEXICO,MORELOS,0.0,0,1,0,1
287,15065,2013,MEXICO,OTUMBA,20.448702967983174,0,1,0,1
288,15080,2013,MEXICO,SULTEPEC,3.874617381533573,1,0,0,1
289,15082,2013,MEXICO,TEJUPILCO,8.44154930568257,0,0,1,1
290,15085,2013,MEXICO,TEMASCALCINGO,4.785070579791052,0,1,0,1
291,15086,2013,MEXICO,TEMASCALTEPEC,9.12686340127776,0,1,0,1
292,15087,2013,MEXICO,TEMOAYA,5.5549383401844254,0,1,0,1
293,15088,2013,MEXICO,TENANCINGO,5.497767906230072,0,0,1,1
294,15101,2013,MEXICO,TIANGUISTENCO,8.488724144761044,1,0,0,1
295,15113,2013,MEXICO,VILLA GUERRERO,6.667666816689169,0,0,1,1
296,15119,2013,MEXICO,ZUMPAHUACAN,6.110601894286589,0,1,0,1
297,15120,2013,MEXICO,ZUMPANGO,15.03316692452724,0,1,0,1
298,15123,2013,MEXICO,LUVIANOS,17.997912242179908,0,1,0,1
299,16001,2013,MICHOACAN,ACUITZIO,36.40666241922272,0,1,0,1
300,16002,2013,MICHOACAN,AGUILILLA,55.507586036758354,0,1,0,1
301,16003,2013,MICHOACAN,ALVARO OBREGON,23.908573614498163,0,6,0,6
302,16006,2013,MICHOACAN,APATZINGAN,57.42060186495645,0,1,1,2
303,16009,2013,MICHOACAN,ARIO,11.47842056932966,1,2,0,3
304,16011,2013,MICHOACAN,BRISE?AS,46.93513564254201,0,2,0,2
305,16013,2013,MICHOACAN,CARACUARO,0.0,1,3,0,4
306,16016,2013,MICHOACAN,COENEO,0.0,0,1,0,1
307,16019,2013,MICHOACAN,COTIJA,15.27183872938302,1,1,0,2
308,16020,2013,MICHOACAN,CUITZEO,10.628122010840684,0,1,0,1
309,16022,2013,MICHOACAN,CHARO,55.24098881369977,0,1,0,1
310,16024,2013,MICHOACAN,CHERAN,0.0,0,1,0,1
311,16025,2013,MICHOACAN,CHILCHOTA,5.510704543575896,1,1,0,2
312,16028,2013,MICHOACAN,CHURINTZIO,0.0,1,4,0,5
313,16029,2013,MICHOACAN,CHURUMUCO,20.882639565641092,0,3,0,3
314,16030,2013,MICHOACAN,ECUANDUREO,31.11629716063788,1,0,0,1
315,16031,2013,MICHOACAN,EPITACIO HUERTA,12.33197681588359,1,0,0,1
316,16034,2013,MICHOACAN,HIDALGO,11.052542084679477,3,2,2,7
317,16035,2013,MICHOACAN,LA HUACANA,27.47504350215221,0,1,0,1
318,16036,2013,MICHOACAN,HUANDACAREO,25.87991718426501,1,1,0,2
319,16038,2013,MICHOACAN,HUETAMO,19.076233397715626,3,1,0,4
320,16040,2013,MICHOACAN,INDAPARAPEO,12.175077616119802,2,1,0,3
321,16042,2013,MICHOACAN,IXTLAN,22.084805653710244,0,1,0,1
322,16043,2013,MICHOACAN,JACONA,6.24892596584962,0,2,0,2
323,16045,2013,MICHOACAN,JIQUILPAN,23.39249685663324,0,3,0,3
324,16046,2013,MICHOACAN,JUAREZ,0.0,0,1,0,1
325,16050,2013,MICHOACAN,MARAVATIO,7.475890253931071,2,1,0,3
326,16051,2013,MICHOACAN,MARCOS CASTELLANOS,0.0,1,2,0,3
327,16053,2013,MICHOACAN,MORELIA,27.287224779542537,0,4,0,4
328,16054,2013,MICHOACAN,MORELOS,24.718823384006924,0,2,0,2
329,16055,2013,MICHOACAN,MUGICA,24.46455974912706,1,2,0,3
330,16062,2013,MICHOACAN,PAJACUARAN,10.282776349614396,0,3,0,3
331,16063,2013,MICHOACAN,PANINDICUARO,18.67529880478088,0,2,0,2
332,16064,2013,MICHOACAN,PARACUARO,23.67517657735864,0,2,0,2
333,16066,2013,MICHOACAN,PATZCUARO,14.807390026653302,0,1,0,1
334,16067,2013,MICHOACAN,PENJAMILLO,5.8278454455387845,0,1,0,1
335,16069,2013,MICHOACAN,LA PIEDAD,6.025548324897565,0,3,0,3
336,16070,2013,MICHOACAN,PUREPERO,0.0,1,3,0,4
337,16072,2013,MICHOACAN,QUERENDARO,14.760147601476016,0,4,0,4
338,16074,2013,MICHOACAN,COJUMATLAN DE REGULES,10.020040080160319,0,2,0,2
339,16076,2013,MICHOACAN,SAHUAYO,17.84709161049409,1,1,0,2
340,16077,2013,MICHOACAN,SAN LUCAS,21.66729862954336,0,1,0,1
341,16078,2013,MICHOACAN,SANTA ANA MAYA,7.925186241876683,0,2,0,2
342,16081,2013,MICHOACAN,SUSUPUATO,0.0,0,1,0,1
343,16082,2013,MICHOACAN,TACAMBARO,11.435923093417196,1,3,0,4
344,16083,2013,MICHOACAN,TANCITARO,50.99612429455362,0,2,0,2
345,16085,2013,MICHOACAN,TANGANCICUARO,9.1807693484714,0,1,0,1
346,16090,2013,MICHOACAN,TINGAMBATO,7.168458781362008,0,2,0,2
347,16091,2013,MICHOACAN,TING?INDIN,7.401376656058026,0,1,0,1
348,16092,2013,MICHOACAN,TIQUICHEO DE NICOLAS ROMERO,49.0402129746392,0,1,0,1
349,16094,2013,MICHOACAN,TLAZAZALCA,14.513788098693755,0,2,0,2
350,16097,2013,MICHOACAN,TURICATO,15.685290334724096,1,2,0,3
351,16098,2013,MICHOACAN,TUXPAN,11.52693460385768,1,0,0,1
352,16099,2013,MICHOACAN,TUZANTLA,24.532352039251762,1,0,0,1
353,16100,2013,MICHOACAN,TZINTZUNTZAN,7.376807317792858,1,1,0,2
354,16101,2013,MICHOACAN,TZITZIO,0.0,1,2,0,3
355,16102,2013,MICHOACAN,URUAPAN,19.660694466465827,1,2,0,3
356,16103,2013,MICHOACAN,VENUSTIANO CARRANZA,8.526239502067613,1,0,0,1
357,16104,2013,MICHOACAN,VILLAMAR,5.885468777588135,2,2,0,4
358,16105,2013,MICHOACAN,VISTA HERMOSA,31.587259805211897,1,0,0,1
359,16106,2013,MICHOACAN,YURECUARO,60.0100016669445,0,2,0,2
360,16108,2013,MICHOACAN,ZAMORA,16.12019215269046,2,2,0,4
361,16110,2013,MICHOACAN,ZINAPECUARO,10.714438777696824,2,4,0,6
362,16112,2013,MICHOACAN,ZITACUARO,6.4294623683567576,0,2,0,2
363,17005,2013,MORELOS,COATLAN DEL RIO,42.23418857565199,0,2,0,2
364,17009,2013,MORELOS,HUITZILAC,11.534025374855824,0,1,0,1
365,17010,2013,MORELOS,JANTETELCO,25.5656397801355,0,1,0,1
366,17014,2013,MORELOS,MAZATEPEC,21.150592216582066,0,2,0,2
367,17015,2013,MORELOS,MIACATLAN,52.02080832332933,0,2,0,2
368,17016,2013,MORELOS,OCUITUCO,23.727607070826906,0,1,0,1
369,17021,2013,MORELOS,TETECALA,40.31716167181831,0,1,0,1
370,17022,2013,MORELOS,TETELA DEL VOLCAN,10.450412791305256,0,1,0,1
371,17031,2013,MORELOS,ZACATEPEC,31.372101645609327,0,2,0,2
372,17032,2013,MORELOS,ZACUALPAN,0.0,0,1,0,1
373,18001,2013,NAYARIT,ACAPONETA,41.0149841408728,0,1,0,1
374,18002,2013,NAYARIT,AHUACATLAN,26.26567732615405,0,1,0,1
375,18004,2013,NAYARIT,COMPOSTELA,4.261424167956931,0,2,2,4
376,18005,2013,NAYARIT,HUAJICORI,35.08771929824561,1,0,0,1
377,18008,2013,NAYARIT,XALISCO,20.365769215103253,0,2,0,2
378,18009,2013,NAYARIT,DEL NAYAR,52.478134110787174,0,1,0,1
379,18010,2013,NAYARIT,ROSAMORADA,43.61352600819935,0,1,0,1
380,18012,2013,NAYARIT,SAN BLAS,11.595547309833027,0,0,14,14
381,18013,2013,NAYARIT,SAN PEDRO LAGUNILLAS,13.315579227696405,9,11,0,20
382,18014,2013,NAYARIT,SANTA MARIA DEL ORO,0.0,0,2,2,4
383,18015,2013,NAYARIT,SANTIAGO IXCUINTLA,4.29765562885446,0,4,0,4
384,18016,2013,NAYARIT,TECUALA,15.092061575611227,0,5,0,5
385,18017,2013,NAYARIT,TEPIC,7.100610389507928,8,7,0,15
386,18018,2013,NAYARIT,TUXPAN,9.99000999000999,0,2,0,2
387,18020,2013,NAYARIT,BAHIA DE BANDERAS,8.051205668048791,0,1,0,1
388,19005,2013,NUEVO LEON,ANAHUAC,0.0,0,0,1,1
389,19015,2013,NUEVO LEON,DR. COSS,0.0,1,2,0,3
390,19022,2013,NUEVO LEON,GRAL. TERAN,0.0,0,3,0,3
391,19024,2013,NUEVO LEON,GRAL. ZARAGOZA,0.0,0,3,3,6
392,19032,2013,NUEVO LEON,LAMPAZOS DE NARANJO,0.0,1,1,0,2
393,19033,2013,NUEVO LEON,LINARES,0.0,0,0,2,2
394,19034,2013,NUEVO LEON,MARIN,0.0,0,1,0,1
395,19035,2013,NUEVO LEON,MELCHOR OCAMPO,0.0,0,1,0,1
396,19038,2013,NUEVO LEON,MONTEMORELOS,0.0,0,2,2,4
397,19039,2013,NUEVO LEON,MONTERREY,23.424772136849985,1,0,0,1
398,19040,2013,NUEVO LEON,PARAS,0.0,0,1,0,1
399,19044,2013,NUEVO LEON,SABINAS HIDALGO,0.0,1,0,3,4
400,19047,2013,NUEVO LEON,HIDALGO,0.0,0,0,1,1
401,20001,2013,OAXACA,ABEJONES,0.0,1,0,0,1
402,20026,2013,OAXACA,CHALCATONGO DE HIDALGO,0.0,1,0,0,1
403,20031,2013,OAXACA,TAMAZULAPAM DEL ESPIRITU SANTO,0.0,2,2,0,4
404,20088,2013,OAXACA,SAN ANDRES CABECERA NUEVA,0.0,1,0,0,1
405,20105,2013,OAXACA,SAN ANTONINO MONTE VERDE,0.0,1,0,0,1
406,20201,2013,OAXACA,SAN JUAN JUQUILA VIJANOS,0.0,1,0,0,1
407,20209,2013,OAXACA,SAN JUAN MIXTEPEC -DTO. 26 -,0.0,1,0,0,1
408,20247,2013,OAXACA,CAPULALPAM DE MENDEZ,0.0,0,1,0,1
409,20269,2013,OAXACA,SAN MIGUEL EL GRANDE,0.0,2,7,0,9
410,20277,2013,OAXACA,VILLA SOLA DE VEGA,0.0,1,0,0,1
411,20286,2013,OAXACA,SAN MIGUEL TLACOTEPEC,0.0,0,1,0,1
412,20297,2013,OAXACA,SAN PABLO TIJALTEPEC,0.0,0,1,0,1
413,20298,2013,OAXACA,SAN PABLO VILLA DE MITLA,0.0,1,0,0,1
414,20320,2013,OAXACA,SAN PEDRO MOLINOS,0.0,1,0,0,1
415,20372,2013,OAXACA,SANTA CATARINA YOSONOTU,0.0,1,0,0,1
416,20417,2013,OAXACA,SANTA MARIA JACATEPEC,0.0,0,2,0,2
417,20461,2013,OAXACA,SANTIAGO DEL RIO,0.0,0,1,0,1
418,20475,2013,OAXACA,SANTIAGO MATATLAN,0.0,3,2,0,5
419,20517,2013,OAXACA,SANTO DOMINGO TEPUXTEPEC,0.0,1,0,0,1
420,20520,2013,OAXACA,SANTO DOMINGO TONALA,0.0,0,1,0,1
421,20549,2013,OAXACA,TEZOATLAN DE SEGURA Y LUNA,0.0,0,1,0,1
422,20563,2013,OAXACA,YOGANA,0.0,0,1,0,1
423,20566,2013,OAXACA,ZAPOTITLAN DEL RIO,0.0,2,0,0,2
424,21016,2013,PUEBLA,AQUIXTLA,12.742099898063204,0,1,0,1
425,21019,2013,PUEBLA,ATLIXCO,10.23122570083896,0,0,1,1
426,21026,2013,PUEBLA,CALPAN,7.283321194464675,0,0,1,1
427,21042,2013,PUEBLA,CUAYUCA DE ANDRADE,0.0,0,1,0,1
428,21047,2013,PUEBLA,CHIAUTLA,5.252928507643012,2,1,0,3
429,21085,2013,PUEBLA,IZUCAR DE MATAMOROS,15.110097666176735,0,1,0,1
430,21114,2013,PUEBLA,PUEBLA,4.286218055498732,0,0,2,2
431,21127,2013,PUEBLA,SAN JERONIMO XAYACATLAN,26.47603918453799,0,1,0,1
432,21142,2013,PUEBLA,SAN SALVADOR EL SECO,7.2406053146043,1,2,1,4
433,21147,2013,PUEBLA,SANTA INES AHUATEMPAN,0.0,0,1,0,1
434,21151,2013,PUEBLA,SANTO TOMAS HUEYOTLIPAN,12.475049900199599,0,1,1,2
435,21166,2013,PUEBLA,TEPEOJUMA,0.0,1,0,0,1
436,21184,2013,PUEBLA,TLAPACOYA,0.0,0,0,1,1
437,21191,2013,PUEBLA,TULCINGO,21.633315305570573,0,1,0,1
438,21201,2013,PUEBLA,XOCHILTEPEC,0.0,0,1,0,1
439,21203,2013,PUEBLA,XOCHITLAN TODOS SANTOS,0.0,0,2,0,2
440,22001,2013,QUERETARO,AMEALCO DE BONFIL,12.862356705307329,2,6,1,9
441,22003,2013,QUERETARO,ARROYO SECO,0.0,1,5,2,8
442,22004,2013,QUERETARO,CADEREYTA DE MONTES,3.11608993035539,0,1,0,1
443,22007,2013,QUERETARO,EZEQUIEL MONTES,2.6230884243107835,0,1,2,3
444,22008,2013,QUERETARO,HUIMILPAN,0.0,0,2,0,2
445,22009,2013,QUERETARO,JALPAN DE SERRA,3.9138943248532283,3,1,0,4
446,22010,2013,QUERETARO,LANDA DE MATAMOROS,0.0,11,28,2,41
447,22012,2013,QUERETARO,PEDRO ESCOBEDO,7.816652596691992,1,7,4,12
448,22015,2013,QUERETARO,SAN JOAQUIN,0.0,8,10,1,19
449,22016,2013,QUERETARO,SAN JUAN DEL RIO,5.7923284746730435,2,0,0,2
450,23001,2013,QUINTANA ROO,COZUMEL,7.543848620104357,4,0,0,4
451,24001,2013,SAN LUIS POTOSI,AHUALULCO,59.000214546234716,0,1,0,1
452,24004,2013,SAN LUIS POTOSI,ARMADILLO DE LOS INFANTE,22.542831379621283,0,1,0,1
453,24007,2013,SAN LUIS POTOSI,CEDRAL,0.0,0,1,0,1
454,24009,2013,SAN LUIS POTOSI,CERRO DE SAN PEDRO,24.86943546381497,0,1,0,1
455,24018,2013,SAN LUIS POTOSI,HUEHUETLAN,0.0,0,1,0,1
456,24021,2013,SAN LUIS POTOSI,MEXQUITIC DE CARMONA,9.35593727779649,0,1,0,1
457,24023,2013,SAN LUIS POTOSI,RAYON,0.0,0,1,0,1
458,24025,2013,SAN LUIS POTOSI,SALINAS,0.0,0,1,0,1
459,24027,2013,SAN LUIS POTOSI,SAN CIRO DE ACOSTA,9.831874938550783,0,1,0,1
460,24032,2013,SAN LUIS POTOSI,SANTA MARIA DEL RIO,4.959579427664535,0,2,0,2
461,24033,2013,SAN LUIS POTOSI,SANTO DOMINGO,0.0,0,1,0,1
462,24034,2013,SAN LUIS POTOSI,SAN VICENTE TANCUAYALAB,6.685385746757588,0,1,0,1
463,24039,2013,SAN LUIS POTOSI,TAMPAMOLON CORONA,0.0,0,2,0,2
464,24041,2013,SAN LUIS POTOSI,TANLAJAS,10.356255178127588,0,1,0,1
465,24046,2013,SAN LUIS POTOSI,VILLA DE ARRIAGA,12.257906349595487,0,2,0,2
466,24047,2013,SAN LUIS POTOSI,VILLA DE GUADALUPE,0.0,0,1,0,1
467,24049,2013,SAN LUIS POTOSI,VILLA DE RAMOS,5.2731491246572455,0,1,0,1
468,24052,2013,SAN LUIS POTOSI,VILLA JUAREZ,29.486927462158448,0,1,0,1
469,24055,2013,SAN LUIS POTOSI,ZARAGOZA,0.0,0,1,0,1
470,24058,2013,SAN LUIS POTOSI,EL NARANJO,0.0,0,1,0,1
471,25001,2013,SINALOA,AHOME,40.595821753114954,0,3,0,3
472,25006,2013,SINALOA,CULIACAN,55.786023912289,0,7,1,8
473,25008,2013,SINALOA,ELOTA,20.975598387209548,0,1,0,1
474,25011,2013,SINALOA,GUASAVE,24.832815691541448,0,0,4,4
475,26006,2013,SONORA,ARIZPE,0.0,0,1,0,1
476,26012,2013,SONORA,BACUM,0.0,0,1,0,1
477,26014,2013,SONORA,BAVIACORA,0.0,0,1,0,1
478,26030,2013,SONORA,HERMOSILLO,12.749540379069336,1,1,0,2
479,26031,2013,SONORA,HUACHINERA,0.0,0,1,0,1
480,26038,2013,SONORA,MOCTEZUMA,0.0,0,1,0,1
481,26051,2013,SONORA,ROSARIO,0.0,1,1,0,2
482,26061,2013,SONORA,SOYOPA,0.0,0,1,0,1
483,26069,2013,SONORA,YECORA,0.0,0,1,0,1
484,26072,2013,SONORA,SAN IGNACIO RIO MUERTO,0.0,0,1,0,1
485,28003,2013,TAMAULIPAS,ALTAMIRA,8.490525988084961,0,1,0,1
487,28012,2013,TAMAULIPAS,GONZALEZ,25.32519857257972,0,3,0,3
489,28015,2013,TAMAULIPAS,GUSTAVO DIAZ ORDAZ,6.339144215530904,0,2,0,2
490,28016,2013,TAMAULIPAS,HIDALGO,58.840835539864656,0,1,0,1
491,28017,2013,TAMAULIPAS,JAUMAVE,39.72194637537239,0,1,0,1
492,28018,2013,TAMAULIPAS,JIMENEZ,107.93955384984407,0,1,0,1
493,28019,2013,TAMAULIPAS,LLERA,23.077366872439853,0,1,0,1
494,28021,2013,TAMAULIPAS,EL MANTE,11.227027773939476,0,1,0,1
495,28022,2013,TAMAULIPAS,MATAMOROS,14.718117389251278,0,3,0,3
496,28024,2013,TAMAULIPAS,MIER,167.99664006719863,0,1,0,1
497,28032,2013,TAMAULIPAS,REYNOSA,9.361281411615543,0,2,0,2
498,28034,2013,TAMAULIPAS,SAN CARLOS,10.716964955524595,0,1,0,1
499,28039,2013,TAMAULIPAS,TULA,14.507471347744088,1,1,0,2
500,28040,2013,TAMAULIPAS,VALLE HERMOSO,18.99635903118569,0,2,0,2
502,28043,2013,TAMAULIPAS,XICOTENCATL,4.37368789363191,0,1,0,1
503,29007,2013,TLAXCALA,EL CARMEN TEQUEXQUITLA,0.0,0,2,0,2
504,29014,2013,TLAXCALA,HUEYOTLIPAN,0.0,0,3,0,3
505,29029,2013,TLAXCALA,TEPEYANCO,0.0,0,1,0,1
506,29030,2013,TLAXCALA,TERRENATE,0.0,0,1,0,1
507,29034,2013,TLAXCALA,TLAXCO,5.007636645884975,0,1,0,1
508,29036,2013,TLAXCALA,TOTOLAC,4.848484848484849,0,3,0,3
509,30003,2013,VERACRUZ,ACAYUCAN,19.089206246942748,0,2,0,2
510,30004,2013,VERACRUZ,ACTOPAN,12.196906864419185,0,1,0,1
511,30009,2013,VERACRUZ,ALTO LUCERO DE GUTIERREZ BARRIOS,0.0,0,1,0,1
512,30042,2013,VERACRUZ,COLIPA,0.0,0,2,0,2
513,30053,2013,VERACRUZ,CUITLAHUAC,0.0,0,4,0,4
514,30125,2013,VERACRUZ,PASO DEL MACHO,0.0,0,3,0,3
515,30136,2013,VERACRUZ,RAFAEL LUCIO,0.0,0,5,0,5
516,30176,2013,VERACRUZ,TLACOJALPAN,0.0,0,3,0,3
517,30190,2013,VERACRUZ,TUXTILLA,0.0,0,2,0,2
518,30194,2013,VERACRUZ,VILLA ALDAMA,0.0,0,1,0,1
519,30199,2013,VERACRUZ,ZARAGOZA,0.0,0,2,0,2
520,31002,2013,YUCATAN,ACANCEH,0.0,0,1,0,1
521,31003,2013,YUCATAN,AKIL,0.0,0,1,0,1
522,31007,2013,YUCATAN,CACALCHEN,0.0,0,1,0,1
523,31012,2013,YUCATAN,CENOTILLO,0.0,0,1,0,1
524,31016,2013,YUCATAN,CHACSINKIN,0.0,0,1,0,1
525,31023,2013,YUCATAN,CHOCHOLA,0.0,0,1,0,1
526,31028,2013,YUCATAN,DZILAM DE BRAVO,0.0,0,1,0,1
527,31029,2013,YUCATAN,DZILAM GONZALEZ,0.0,0,1,0,1
528,31032,2013,YUCATAN,ESPITA,0.0,0,1,0,1
529,31036,2013,YUCATAN,HOMUN,0.0,0,1,0,1
530,31039,2013,YUCATAN,IXIL,0.0,0,1,0,1
531,31049,2013,YUCATAN,MAYAPAN,0.0,0,1,0,1
532,31052,2013,YUCATAN,MOTUL,2.943080816999234,0,1,0,1
533,31058,2013,YUCATAN,PETO,0.0,0,1,0,1
534,31061,2013,YUCATAN,RIO LAGARTOS,0.0,0,1,0,1
535,31062,2013,YUCATAN,SACALUM,0.0,0,1,0,1
536,31073,2013,YUCATAN,TAHDZIU,0.0,1,0,0,1
537,31083,2013,YUCATAN,TELCHAC PUERTO,0.0,0,1,0,1
538,31086,2013,YUCATAN,TEPAKAN,0.0,0,1,0,1
539,31089,2013,YUCATAN,TICUL,2.65357569324665,0,1,0,1
540,31096,2013,YUCATAN,TIZIMIN,1.367278295824332,0,1,0,1
541,31098,2013,YUCATAN,TZUCACAB,0.0,0,1,0,1
542,31101,2013,YUCATAN,UMAN,1.961053477928343,0,1,0,1
543,31102,2013,YUCATAN,VALLADOLID,5.3896007653233085,0,1,0,1
544,32001,2013,ZACATECAS,APOZOL,0.0,1,1,1,3
545,32003,2013,ZACATECAS,ATOLINGA,0.0,1,0,0,1
546,32005,2013,ZACATECAS,CALERA,2.5051982864443723,0,10,0,10
547,32009,2013,ZACATECAS,CHALCHIHUITES,0.0,0,0,1,1
548,32010,2013,ZACATECAS,FRESNILLO,24.86640173783305,4,1,6,11
549,32011,2013,ZACATECAS,TRINIDAD GARCIA DE LA CADENA,0.0,0,4,0,4
550,32014,2013,ZACATECAS,GENERAL FRANCISCO R. MURGUIA,0.0,1,10,0,11
551,32015,2013,ZACATECAS,EL PLATEADO DE JOAQUIN AMARO,0.0,1,0,0,1
552,32017,2013,ZACATECAS,GUADALUPE,0.0,0,6,2,8
553,32019,2013,ZACATECAS,JALPA,8.490045421743007,1,7,1,9
554,32020,2013,ZACATECAS,JEREZ,10.414858531504947,3,9,0,12
555,32022,2013,ZACATECAS,JUAN ALDAMA,0.0,1,6,1,8
556,32023,2013,ZACATECAS,JUCHIPILA,32.56268316509281,2,3,2,7
557,32024,2013,ZACATECAS,LORETO,0.0,0,1,0,1
558,32025,2013,ZACATECAS,LUIS MOYA,0.0,0,4,2,6
559,32028,2013,ZACATECAS,MEZQUITAL DEL ORO,0.0,1,0,0,1
560,32029,2013,ZACATECAS,MIGUEL AUZA,22.425547183351274,1,1,2,4
561,32030,2013,ZACATECAS,MOMAX,0.0,1,9,0,10
562,32032,2013,ZACATECAS,MORELOS,0.0,1,7,0,8
563,32033,2013,ZACATECAS,MOYAHUA DE ESTRADA,0.0,0,1,0,1
564,32034,2013,ZACATECAS,NOCHISTLAN DE MEJIA,17.900615781182875,3,14,5,22
565,32036,2013,ZACATECAS,OJOCALIENTE,12.272950417280311,0,1,0,1
566,32037,2013,ZACATECAS,PANUCO,0.0,0,0,4,4
567,32038,2013,ZACATECAS,PINOS,5.727048851726705,0,15,0,15
568,32039,2013,ZACATECAS,RIO GRANDE,14.355669691991134,2,5,0,7
569,32040,2013,ZACATECAS,SAIN ALTO,0.0,0,2,0,2
570,32042,2013,ZACATECAS,SOMBRERETE,26.14891808851409,3,4,0,7
571,32045,2013,ZACATECAS,TEPECHITLAN,0.0,5,8,1,14
572,32046,2013,ZACATECAS,TEPETONGO,0.0,1,0,0,1
573,32048,2013,ZACATECAS,TLALTENANGO DE SANCHEZ ROMAN,15.690581728317573,1,3,0,4
574,32049,2013,ZACATECAS,VALPARAISO,27.008372595504607,14,6,1,21
575,32050,2013,ZACATECAS,VETAGRANDE,0.0,0,2,0,2
576,32051,2013,ZACATECAS,VILLA DE COS,0.0,1,4,1,6
577,32052,2013,ZACATECAS,VILLA GARCIA,0.0,0,3,0,3
578,32053,2013,ZACATECAS,VILLA GONZALEZ ORTEGA,0.0,0,2,0,2
579,32054,2013,ZACATECAS,VILLA HIDALGO,0.0,0,6,0,6
580,32055,2013,ZACATECAS,VILLANUEVA,6.803878210580031,1,6,0,7
581,32056,2013,ZACATECAS,ZACATECAS,28.224872626215838,0,2,2,4
582,32057,2013,ZACATECAS,TRANCOSO,0.0,0,2,0,2
0,1001,2014,AGUASCALIENTES,AGUASCALIENTES,3.889537145079735,1,4,1,6
1,1002,2014,AGUASCALIENTES,ASIENTOS,0.0,2,6,1,9
2,1003,2014,AGUASCALIENTES,CALVILLO,3.694399290675337,3,2,5,10
3,1004,2014,AGUASCALIENTES,COSIO,0.0,2,3,0,5
4,1005,2014,AGUASCALIENTES,JESUS MARIA,6.024701275228437,0,0,2,2
5,1006,2014,AGUASCALIENTES,PABELLON DE ARTEAGA,0.0,1,0,0,1
6,1007,2014,AGUASCALIENTES,RINCON DE ROMOS,2.034339653348523,1,2,0,3
7,1008,2014,AGUASCALIENTES,SAN JOSE DE GRACIA,0.0,1,2,0,3
8,1009,2014,AGUASCALIENTES,TEPEZALA,0.0,2,1,1,4
9,1011,2014,AGUASCALIENTES,SAN FRANCISCO DE LOS ROMO,2.795716961614806,1,0,0,1
10,2001,2014,BAJA CALIFORNIA,ENSENADA,10.710904128839324,0,1,0,1
11,2004,2014,BAJA CALIFORNIA,TIJUANA,29.62140383654884,10,3,2,15
12,2005,2014,BAJA CALIFORNIA,PLAYAS DE ROSARITO,49.631623064366714,1,1,4,6
13,4001,2014,CAMPECHE,CALKINI,1.890716581584421,0,2,0,2
14,4004,2014,CAMPECHE,CHAMPOTON,9.636116163380347,1,1,2,4
15,4007,2014,CAMPECHE,PALIZADA,0.0,0,1,0,1
16,4008,2014,CAMPECHE,TENABO,0.0,0,1,0,1
17,4009,2014,CAMPECHE,ESCARCEGA,9.227816329543778,0,1,1,2
18,4010,2014,CAMPECHE,CALAKMUL,7.4399226248047015,0,2,0,2
19,4011,2014,CAMPECHE,CANDELARIA,24.275379909695587,0,1,0,1
20,6002,2014,COLIMA,COLIMA,13.614333169961336,3,8,0,11
21,6003,2014,COLIMA,COMALA,14.362313289927233,0,2,0,2
22,6005,2014,COLIMA,CUAUHTEMOC,14.756336001770759,1,0,0,1
23,6006,2014,COLIMA,IXTLAHUACAN,0.0,0,6,0,6
24,6007,2014,COLIMA,MANZANILLO,13.629042250030976,0,12,0,12
25,6008,2014,COLIMA,MINATITLAN,36.701737215561536,0,3,0,3
26,6009,2014,COLIMA,TECOMAN,19.51634937813814,0,9,0,9
27,6010,2014,COLIMA,VILLA DE ALVAREZ,6.66911200773617,0,1,0,1
28,7002,2014,CHIAPAS,ACALA,10.363768266141571,0,0,1,1
29,7009,2014,CHIAPAS,ARRIAGA,32.465910793666644,0,0,3,3
30,7017,2014,CHIAPAS,CINTALAPA,8.961261745653786,0,5,0,5
31,7032,2014,CHIAPAS,ESCUINTLA,13.303179459890915,0,0,1,1
32,7041,2014,CHIAPAS,LA INDEPENDENCIA,0.0,0,5,0,5
33,7044,2014,CHIAPAS,IXTAPA,4.078802463596688,0,0,1,1
34,7052,2014,CHIAPAS,LAS MARGARITAS,2.690969107674644,0,0,1,1
35,7057,2014,CHIAPAS,MOTOZINTLA,5.787120762742517,0,4,0,4
36,7061,2014,CHIAPAS,OCOZOCOAUTLA DE ESPINOSA,7.3118122326618655,0,0,1,1
37,7064,2014,CHIAPAS,OXCHUC,2.306805074971165,0,0,1,1
38,7069,2014,CHIAPAS,PIJIJIAPAN,7.987379939695282,0,3,0,3
39,7092,2014,CHIAPAS,TECPATAN,14.618102083079547,0,0,1,1
40,7097,2014,CHIAPAS,TONALA,7.092701610043267,0,5,0,5
41,7099,2014,CHIAPAS,LA TRINITARIA,4.122634638376232,0,0,1,1
42,7101,2014,CHIAPAS,TUXTLA GUTIERREZ,7.589803640937233,1,1,1,3
43,7103,2014,CHIAPAS,TUZANTAN,3.5540391655116044,0,1,0,1
44,7104,2014,CHIAPAS,TZIMOL,0.0,0,0,1,1
45,7107,2014,CHIAPAS,VILLA CORZO,13.426964029163369,0,0,1,1
46,7108,2014,CHIAPAS,VILLAFLORES,1.0140136689042567,0,5,0,5
47,7110,2014,CHIAPAS,SAN LUCAS,0.0,0,0,2,2
48,7111,2014,CHIAPAS,ZINACANTAN,2.7405519471621584,0,0,1,1
49,8006,2014,CHIHUAHUA,BACHINIVA,16.636167027116954,1,0,0,1
50,8009,2014,CHIHUAHUA,BOCOYNA,97.33713411666551,1,0,0,1
51,8013,2014,CHIHUAHUA,CASAS GRANDES,28.336639274582037,0,1,0,1
52,8017,2014,CHIHUAHUA,CUAUHTEMOC,24.57336118314268,1,0,0,1
53,8018,2014,CHIHUAHUA,CUSIHUIRIACHI,18.470631695603988,1,0,0,1
54,8019,2014,CHIHUAHUA,CHIHUAHUA,22.45153701514137,3,0,0,3
55,8022,2014,CHIHUAHUA,DR. BELISARIO DOMINGUEZ,34.352456200618356,1,0,0,1
56,8023,2014,CHIHUAHUA,GALEANA,0.0,1,0,0,1
57,8024,2014,CHIHUAHUA,SANTA ISABEL,25.4000508001016,2,0,0,2
58,8025,2014,CHIHUAHUA,GOMEZ FARIAS,0.0,2,0,0,2
59,8026,2014,CHIHUAHUA,GRAN MORELOS,93.48706762231224,1,0,0,1
60,8027,2014,CHIHUAHUA,GUACHOCHI,82.51323230493671,1,0,0,1
61,8031,2014,CHIHUAHUA,GUERRERO,27.759551809418053,1,0,0,1
62,8034,2014,CHIHUAHUA,IGNACIO ZARAGOZA,14.421690222094028,1,0,0,1
63,8036,2014,CHIHUAHUA,JIMENEZ,58.160668847691745,2,0,0,2
64,8039,2014,CHIHUAHUA,LOPEZ,24.84472049689441,2,0,0,2
65,8040,2014,CHIHUAHUA,MADERA,23.639863564216,1,1,0,2
66,8045,2014,CHIHUAHUA,MEOQUI,27.376634042844433,2,0,0,2
67,8046,2014,CHIHUAHUA,MORELOS,95.8887690279276,1,0,0,1
68,8047,2014,CHIHUAHUA,MORIS,94.12650602409641,1,0,0,1
69,8048,2014,CHIHUAHUA,NAMIQUIPA,17.482517482517483,2,0,0,2
70,8049,2014,CHIHUAHUA,NONOAVA,0.0,1,0,0,1
71,8050,2014,CHIHUAHUA,NUEVO CASAS GRANDES,13.482312890776413,1,2,0,3
72,8051,2014,CHIHUAHUA,OCAMPO,39.7561622051418,1,0,0,1
73,8054,2014,CHIHUAHUA,RIVA PALACIO,24.962556165751376,1,0,0,1
74,8057,2014,CHIHUAHUA,SAN FRANCISCO DE BORJA,0.0,1,0,0,1
75,8063,2014,CHIHUAHUA,TEMOSACHIC,80.50233456770246,1,0,0,1
76,8066,2014,CHIHUAHUA,URUACHI,73.17073170731706,1,0,0,1
77,10001,2014,DURANGO,CANATLAN,9.553835865099838,0,3,0,3
78,10002,2014,DURANGO,CANELAS,0.0,0,2,0,2
79,10004,2014,DURANGO,CUENCAME,11.88212927756654,0,1,0,1
80,10005,2014,DURANGO,DURANGO,7.556670736964314,0,9,0,9
81,10006,2014,DURANGO,GENERAL SIMON BOLIVAR,0.0,0,5,0,5
82,10008,2014,DURANGO,GUADALUPE VICTORIA,0.0,0,7,0,7
83,10009,2014,DURANGO,GUANACEVI,39.41275002463297,0,3,0,3
84,10010,2014,DURANGO,HIDALGO,0.0,0,2,0,2
85,10011,2014,DURANGO,INDE,0.0,0,11,0,11
86,10013,2014,DURANGO,MAPIMI,19.890997334606357,0,4,0,4
87,10015,2014,DURANGO,NAZAS,8.057368463459834,0,4,0,4
88,10016,2014,DURANGO,NOMBRE DE DIOS,0.0,0,5,0,5
89,10017,2014,DURANGO,OCAMPO,0.0,0,1,0,1
90,10018,2014,DURANGO,EL ORO,35.33568904593639,0,3,0,3
91,10020,2014,DURANGO,PANUCO DE CORONADO,16.768676113020874,0,5,0,5
92,10021,2014,DURANGO,PE?ON BLANCO,0.0,0,9,0,9
93,10022,2014,DURANGO,POANAS,8.026326350429407,0,6,0,6
94,10024,2014,DURANGO,RODEO,0.0,0,10,0,10
95,10025,2014,DURANGO,SAN BERNARDO,0.0,0,4,0,4
96,10027,2014,DURANGO,SAN JUAN DE GUADALUPE,0.0,0,2,0,2
97,10028,2014,DURANGO,SAN JUAN DEL RIO,25.305778152678194,0,3,0,3
98,10029,2014,DURANGO,SAN LUIS DEL CORDERO,0.0,0,4,0,4
99,10030,2014,DURANGO,SAN PEDRO DEL GALLO,0.0,0,1,0,1
100,10031,2014,DURANGO,SANTA CLARA,0.0,0,2,0,2
101,10034,2014,DURANGO,TAMAZULA,159.28398058252424,0,2,0,2
102,10035,2014,DURANGO,TEPEHUANES,83.75988832014893,0,16,0,16
103,10036,2014,DURANGO,TLAHUALILO,8.991188635137563,0,15,0,15
104,10037,2014,DURANGO,TOPIA,0.0,0,4,0,4
105,10038,2014,DURANGO,VICENTE GUERRERO,9.471042288203817,0,7,0,7
106,10039,2014,DURANGO,NUEVO IDEAL,3.832592365476008,0,3,0,3
107,11001,2014,GUANAJUATO,ABASOLO,1.1857894986481998,0,0,1,1
108,11002,2014,GUANAJUATO,ACAMBARO,30.26689901861873,0,16,0,16
109,11004,2014,GUANAJUATO,APASEO EL ALTO,6.207999006720159,0,4,0,4
110,11005,2014,GUANAJUATO,APASEO EL GRANDE,8.204503100130099,0,2,0,2
111,11009,2014,GUANAJUATO,COMONFORT,10.283569426948093,0,1,0,1
112,11010,2014,GUANAJUATO,CORONEO,25.660764690787786,0,24,0,24
113,11011,2014,GUANAJUATO,CORTAZAR,20.3626819914703,0,5,0,5
114,11013,2014,GUANAJUATO,DOCTOR MORA,12.862287772251758,0,34,0,34
115,11015,2014,GUANAJUATO,GUANAJUATO,8.735709834662131,0,5,0,5
116,11016,2014,GUANAJUATO,HUANIMARO,0.0,0,1,0,1
117,11017,2014,GUANAJUATO,IRAPUATO,10.954971290420067,0,0,1,1
118,11019,2014,GUANAJUATO,JERECUARO,31.476235442241112,0,18,0,18
119,11020,2014,GUANAJUATO,LEON,11.556025840944534,0,14,12,26
120,11021,2014,GUANAJUATO,MOROLEON,28.360748723766307,0,1,0,1
121,11022,2014,GUANAJUATO,OCAMPO,0.0,0,11,0,11
122,11024,2014,GUANAJUATO,PUEBLO NUEVO,35.813412122840006,0,0,4,4
123,11025,2014,GUANAJUATO,PURISIMA DEL RINCON,2.907188022385348,0,5,0,5
124,11026,2014,GUANAJUATO,ROMITA,10.590415673815198,0,1,3,4
125,11027,2014,GUANAJUATO,SALAMANCA,14.957887792829421,0,0,1,1
126,11028,2014,GUANAJUATO,SALVATIERRA,14.424959301007686,0,5,0,5
127,11029,2014,GUANAJUATO,SAN DIEGO DE LA UNION,5.3903996981376165,0,40,0,40
128,11031,2014,GUANAJUATO,SAN FRANCISCO DEL RINCON,13.20771330456987,0,6,3,9
129,11032,2014,GUANAJUATO,SAN JOSE ITURBIDE,8.28603388987861,0,5,0,5
130,11033,2014,GUANAJUATO,SAN LUIS DE LA PAZ,6.052431348135852,2,1,0,3
131,11035,2014,GUANAJUATO,SANTA CRUZ DE JUVENTINO ROSAS,18.936046658418967,0,5,0,5
132,11036,2014,GUANAJUATO,SANTIAGO MARAVATIO,0.0,1,23,0,24
133,11038,2014,GUANAJUATO,TARANDACUAO,42.95163645734903,0,5,0,5
134,11042,2014,GUANAJUATO,VALLE DE SANTIAGO,10.633923634249742,0,2,8,10
135,11044,2014,GUANAJUATO,VILLAGRAN,23.305008784195614,0,6,8,14
136,11046,2014,GUANAJUATO,YURIRIA,12.715097058574214,0,2,5,7
137,12001,2014,GUERRERO,ACAPULCO DE JUAREZ,74.68628595226913,0,0,1,1
138,12006,2014,GUERRERO,APAXTLA,64.57341189765114,1,3,1,5
139,12008,2014,GUERRERO,ATENANGO DEL RIO,11.918951132300355,0,1,0,1
140,12011,2014,GUERRERO,ATOYAC DE ALVAREZ,61.97403614064845,3,3,0,6
141,12012,2014,GUERRERO,AYUTLA DE LOS LIBRES,17.546658159196046,0,1,0,1
142,12014,2014,GUERRERO,BENITO JUAREZ,33.29116452493509,2,1,0,3
143,12015,2014,GUERRERO,BUENAVISTA DE CUELLAR,15.762925598991172,0,10,0,10
144,12016,2014,GUERRERO,COAHUAYUTLA DE JOSE MARIA IZAZAGA,15.355086372360844,0,1,0,1
145,12017,2014,GUERRERO,COCULA,20.39844971782145,0,13,0,13
146,12021,2014,GUERRERO,COYUCA DE BENITEZ,65.34168254832562,1,0,0,1
147,12028,2014,GUERRERO,CHILAPA DE ALVAREZ,45.53357065982284,0,1,0,1
148,12029,2014,GUERRERO,CHILPANCINGO DE LOS BRAVO,68.67535175432428,1,1,0,2
149,12033,2014,GUERRERO,HUAMUXTITLAN,34.739109289237824,0,1,0,1
150,12034,2014,GUERRERO,HUITZUCO DE LOS FIGUEROA,21.410983834707206,0,2,0,2
151,12035,2014,GUERRERO,IGUALA DE LA INDEPENDENCIA,52.008007808325566,4,19,0,23
152,12037,2014,GUERRERO,IXCATEOPAN DE CUAUHTEMOC,30.289262456459184,0,2,0,2
153,12039,2014,GUERRERO,JUAN R. ESCUDERO,24.62649811196848,1,0,0,1
154,12044,2014,GUERRERO,MOCHITLAN,0.0,0,1,1,2
155,12048,2014,GUERRERO,PETATLAN,13.339558460614953,1,0,0,1
156,12049,2014,GUERRERO,PILCAYA,25.956047759127873,0,3,0,3
157,12051,2014,GUERRERO,QUECHULTENANGO,5.7590416954618755,1,0,0,1
158,12055,2014,GUERRERO,TAXCO DE ALARCON,18.259925230411426,0,27,0,27
159,12057,2014,GUERRERO,TECPAN DE GALEANA,37.054340996600665,2,0,0,2
160,12058,2014,GUERRERO,TELOLOAPAN,81.83153861890679,6,1,1,8
161,12059,2014,GUERRERO,TEPECOACUILCO DE TRUJANO,3.281916639317361,0,1,0,1
162,12060,2014,GUERRERO,TETIPAC,7.617306520414382,0,5,0,5
163,12061,2014,GUERRERO,TIXTLA DE GUERRERO,34.94932348095262,3,0,0,3
164,12067,2014,GUERRERO,TLAPEHUALA,22.915807323892018,0,2,1,3
165,12068,2014,GUERRERO,LA UNION DE ISIDORO MONTES DE OCA,93.34163036714376,0,1,0,1
166,12080,2014,GUERRERO,JUCHITAN,13.954786491766678,0,3,2,5
167,13001,2014,HIDALGO,ACATLAN,4.980823828261196,0,1,0,1
168,13002,2014,HIDALGO,ACAXOCHITLAN,2.4640859473178423,0,1,0,1
169,13003,2014,HIDALGO,ACTOPAN,3.6833090848818575,1,9,0,10
170,13006,2014,HIDALGO,ALFAJAYUCAN,0.0,0,2,1,3
171,13007,2014,HIDALGO,ALMOLOYA,0.0,0,2,0,2
172,13009,2014,HIDALGO,EL ARENAL,0.0,0,3,0,3
173,13010,2014,HIDALGO,ATITALAQUIA,0.0,0,1,0,1
174,13011,2014,HIDALGO,ATLAPEXCO,0.0,0,3,0,3
175,13012,2014,HIDALGO,ATOTONILCO EL GRANDE,11.135857461024498,0,3,2,5
176,13014,2014,HIDALGO,CALNALI,5.895531187359982,0,2,0,2
177,13018,2014,HIDALGO,CHAPULHUACAN,4.463887152932773,0,1,0,1
178,13022,2014,HIDALGO,EPAZOYUCAN,7.230657989877079,0,3,1,4
179,13025,2014,HIDALGO,HUAUTLA,0.0,0,1,0,1
180,13028,2014,HIDALGO,HUEJUTLA DE REYES,4.068182742768805,0,2,0,2
181,13029,2014,HIDALGO,HUICHAPAN,6.7792014100738935,0,3,0,3
182,13030,2014,HIDALGO,IXMIQUILPAN,4.631613075043712,0,5,3,8
183,13034,2014,HIDALGO,LOLOTLA,0.0,0,2,0,2
184,13036,2014,HIDALGO,SAN AGUSTIN METZQUITITLAN,10.679196924391288,0,3,0,3
185,13040,2014,HIDALGO,LA MISION,9.567546880979716,1,1,0,2
186,13041,2014,HIDALGO,MIXQUIAHUALA DE JUAREZ,2.334594014100948,0,1,0,1
187,13042,2014,HIDALGO,MOLANGO DE ESCAMILLA,8.92140244446427,0,3,0,3
188,13043,2014,HIDALGO,NICOLAS FLORES,0.0,0,1,0,1
189,13048,2014,HIDALGO,PACHUCA DE SOTO,8.586510964601176,0,0,2,2
190,13051,2014,HIDALGO,MINERAL DE LA REFORMA,2.3547141377036827,0,3,3,6
191,13054,2014,HIDALGO,SAN SALVADOR,3.0512922222561256,1,6,0,7
192,13056,2014,HIDALGO,SANTIAGO TULANTEPEC DE LUGO GUERRERO,5.971040453799075,0,4,0,4
193,13057,2014,HIDALGO,SINGUILUCAN,0.0,0,0,1,1
194,13058,2014,HIDALGO,TASQUILLO,0.0,1,4,0,5
195,13061,2014,HIDALGO,TEPEAPULCO,5.806751316196965,0,1,0,1
196,13066,2014,HIDALGO,VILLA DE TEZONTEPEC,25.742234425948173,0,1,1,2
197,13072,2014,HIDALGO,TLANALAPA,0.0,0,2,0,2
198,13074,2014,HIDALGO,TLAXCOAPAN,0.0,0,1,0,1
199,13077,2014,HIDALGO,TULANCINGO DE BRAVO,5.937302089930335,0,1,0,1
200,13083,2014,HIDALGO,ZEMPOALA,7.664205605089033,0,3,0,3
222,14039,2014,JALISCO,GUADALAJARA,6.35371180499589,1,0,10,11
231,14053,2014,JALISCO,LAGOS DE MORENO,7.151355181806951,1,0,0,1
239,14067,2014,JALISCO,PUERTO VALLARTA,7.0400225280720905,0,1,0,1
242,14070,2014,JALISCO,EL SALTO,20.980133983476332,2,0,0,2
259,14101,2014,JALISCO,TONALA,10.445195105799383,3,0,1,4
270,14120,2014,JALISCO,ZAPOPAN,7.959760596129787,0,0,3,3
273,15001,2014,MEXICO,ACAMBAY,4.924652811976756,0,1,0,1
274,15004,2014,MEXICO,ALMOLOYA DE ALQUISIRAS,6.7312870220786225,0,1,0,1
275,15005,2014,MEXICO,ALMOLOYA DE JUAREZ,2.7090543368573616,0,1,0,1
276,15008,2014,MEXICO,AMATEPEC,22.78423331054909,0,1,2,3
277,15016,2014,MEXICO,AXAPUSCO,19.56258069564537,1,0,0,1
278,15021,2014,MEXICO,COATEPEC HARINAS,8.29324929507381,0,1,2,3
279,15041,2014,MEXICO,IXTAPAN DEL ORO,0.0,0,1,0,1
280,15048,2014,MEXICO,JOCOTITLAN,0.0,0,1,0,1
281,15052,2014,MEXICO,MALINALCO,15.610365282547612,1,0,0,1
282,15056,2014,MEXICO,MORELOS,14.071624569056494,0,1,0,1
283,15064,2014,MEXICO,EL ORO,0.0,0,1,0,1
284,15066,2014,MEXICO,OTZOLOAPAN,41.118421052631575,0,1,0,1
285,15071,2014,MEXICO,POLOTITLAN,0.0,0,1,0,1
286,15075,2014,MEXICO,SAN MARTIN DE LAS PIRAMIDES,12.071948814937027,0,1,0,1
287,15079,2014,MEXICO,SOYANIQUILPAN DE JUAREZ,25.42803865061875,0,1,0,1
288,15082,2014,MEXICO,TEJUPILCO,9.848474189963,1,0,3,4
289,15084,2014,MEXICO,TEMASCALAPA,25.0090310389863,0,1,0,1
290,15085,2014,MEXICO,TEMASCALCINGO,7.9751176329850875,0,1,0,1
291,15086,2014,MEXICO,TEMASCALTEPEC,24.338302403407358,0,0,1,1
292,15087,2014,MEXICO,TEMOAYA,9.998889012331963,0,1,0,1
293,15088,2014,MEXICO,TENANCINGO,3.298660743738042,0,1,0,1
294,15097,2014,MEXICO,TEXCALTITLAN,5.750431282346176,0,0,1,1
295,15101,2014,MEXICO,TIANGUISTENCO,9.903511502221217,1,0,0,1
296,15102,2014,MEXICO,TIMILPAN,0.0,0,1,0,1
297,15107,2014,MEXICO,TONATICO,8.265145879824777,0,1,0,1
298,15117,2014,MEXICO,ZACUALPAN,26.453276899675952,1,0,0,1
299,15118,2014,MEXICO,ZINACANTEPEC,7.153118461602657,0,1,0,1
300,15120,2014,MEXICO,ZUMPANGO,8.142965417452254,0,1,0,1
301,15123,2014,MEXICO,LUVIANOS,39.5954069327958,0,1,0,1
302,15124,2014,MEXICO,SAN JOSE DEL RINCON,2.189501341069571,0,1,0,1
303,16003,2014,MICHOACAN,ALVARO OBREGON,14.345144168698894,2,1,1,4
304,16006,2014,MICHOACAN,APATZINGAN,35.58459833884625,0,1,0,1
305,16009,2014,MICHOACAN,ARIO,34.435261707988985,1,1,0,2
306,16013,2014,MICHOACAN,CARACUARO,43.42162396873643,2,0,0,2
307,16016,2014,MICHOACAN,COENEO,4.879953152449737,0,1,0,1
308,16017,2014,MICHOACAN,CONTEPEC,15.172664926867757,0,1,0,1
309,16019,2014,MICHOACAN,COTIJA,5.0906129097943404,0,1,0,1
310,16020,2014,MICHOACAN,CUITZEO,14.170829347787578,1,2,0,3
311,16021,2014,MICHOACAN,CHARAPAN,0.0,1,3,0,4
312,16024,2014,MICHOACAN,CHERAN,0.0,0,1,0,1
313,16025,2014,MICHOACAN,CHILCHOTA,13.77676135893974,1,2,0,3
314,16028,2014,MICHOACAN,CHURINTZIO,17.972681524083395,1,2,0,3
315,16029,2014,MICHOACAN,CHURUMUCO,13.921759710427398,0,2,0,2
316,16030,2014,MICHOACAN,ECUANDUREO,38.895371450797356,1,3,1,5
317,16031,2014,MICHOACAN,EPITACIO HUERTA,0.0,1,0,0,1
318,16032,2014,MICHOACAN,ERONGARICUARO,41.222947440742026,0,0,1,1
319,16033,2014,MICHOACAN,GABRIEL ZAMORA,28.176951253874325,0,1,0,1
320,16034,2014,MICHOACAN,HIDALGO,13.603128719605513,3,0,0,3
321,16035,2014,MICHOACAN,LA HUACANA,30.52782611350246,0,2,0,2
322,16036,2014,MICHOACAN,HUANDACAREO,17.25327812284334,2,1,0,3
323,16037,2014,MICHOACAN,HUANIQUEO,75.15971439308531,1,0,0,1
324,16038,2014,MICHOACAN,HUETAMO,19.076233397715626,1,0,0,1
325,16040,2014,MICHOACAN,INDAPARAPEO,6.087538808059901,1,0,0,1
326,16042,2014,MICHOACAN,IXTLAN,7.3616018845700815,1,0,0,1
327,16045,2014,MICHOACAN,JIQUILPAN,38.012807392028996,1,3,0,4
328,16046,2014,MICHOACAN,JUAREZ,0.0,1,0,0,1
329,16050,2014,MICHOACAN,MARAVATIO,11.213835380896606,2,0,0,2
330,16051,2014,MICHOACAN,MARCOS CASTELLANOS,7.674008134448623,1,0,0,1
331,16053,2014,MICHOACAN,MORELIA,24.95615532601378,2,3,3,8
332,16054,2014,MICHOACAN,MORELOS,0.0,0,1,0,1
333,16055,2014,MICHOACAN,MUGICA,24.46455974912706,2,0,0,2
334,16060,2014,MICHOACAN,NUMARAN,0.0,0,2,0,2
335,16062,2014,MICHOACAN,PAJACUARAN,35.98971722365038,3,2,0,5
336,16063,2014,MICHOACAN,PANINDICUARO,12.450199203187251,1,0,0,1
337,16064,2014,MICHOACAN,PARACUARO,31.56690210314485,0,3,0,3
338,16066,2014,MICHOACAN,PATZCUARO,19.363510034854322,0,1,0,1
339,16067,2014,MICHOACAN,PENJAMILLO,5.8278454455387845,0,2,0,2
340,16069,2014,MICHOACAN,LA PIEDAD,34.14477384108621,0,2,0,2
341,16070,2014,MICHOACAN,PUREPERO,6.5333856004181365,1,1,0,2
342,16072,2014,MICHOACAN,QUERENDARO,0.0,1,1,0,2
343,16073,2014,MICHOACAN,QUIROGA,19.537355423569867,1,1,0,2
344,16074,2014,MICHOACAN,COJUMATLAN DE REGULES,10.020040080160319,0,1,0,1
345,16076,2014,MICHOACAN,SAHUAYO,6.864266004036187,1,2,0,3
346,16078,2014,MICHOACAN,SANTA ANA MAYA,0.0,0,2,0,2
347,16082,2014,MICHOACAN,TACAMBARO,11.435923093417196,2,0,1,3
348,16083,2014,MICHOACAN,TANCITARO,30.597674576732175,0,2,0,2
349,16085,2014,MICHOACAN,TANGANCICUARO,18.3615386969428,1,0,0,1
350,16091,2014,MICHOACAN,TING?INDIN,22.204129968174076,0,1,0,1
351,16094,2014,MICHOACAN,TLAZAZALCA,43.541364296081284,2,0,0,2
352,16097,2014,MICHOACAN,TURICATO,12.548232267779277,2,2,0,4
353,16098,2014,MICHOACAN,TUXPAN,7.684623069238452,2,0,0,2
354,16100,2014,MICHOACAN,TZINTZUNTZAN,22.130421953378576,1,0,1,2
355,16101,2014,MICHOACAN,TZITZIO,32.7296530656775,1,4,0,5
356,16102,2014,MICHOACAN,URUAPAN,25.05153004598065,3,0,0,3
357,16103,2014,MICHOACAN,VENUSTIANO CARRANZA,38.368077759304256,1,0,0,1
358,16104,2014,MICHOACAN,VILLAMAR,17.656406332764405,2,0,0,2
359,16106,2014,MICHOACAN,YURECUARO,33.338889814969164,1,1,0,2
360,16107,2014,MICHOACAN,ZACAPU,5.445510856987271,0,1,0,1
361,16108,2014,MICHOACAN,ZAMORA,15.582852414267444,2,2,0,4
362,16110,2014,MICHOACAN,ZINAPECUARO,32.143316333090475,5,0,0,5
363,17002,2014,MORELOS,ATLATLAHUCAN,15.877216194760518,0,1,0,1
364,17005,2014,MORELOS,COATLAN DEL RIO,10.558547143912998,0,1,0,1
365,17006,2014,MORELOS,CUAUTLA,28.53767258157493,0,1,1,2
366,17010,2014,MORELOS,JANTETELCO,6.391409945033875,1,0,0,1
367,17011,2014,MORELOS,JIUTEPEC,19.293943225033377,1,0,0,1
368,17012,2014,MORELOS,JOJUTLA,38.10215004989567,1,0,0,1
369,17015,2014,MORELOS,MIACATLAN,36.01440576230492,0,1,0,1
370,17021,2014,MORELOS,TETECALA,120.9514850154549,1,0,1,2
371,17030,2014,MORELOS,YECAPIXTLA,14.954389113204725,0,2,0,2
372,17031,2014,MORELOS,ZACATEPEC,19.964064683569575,0,1,0,1
373,17032,2014,MORELOS,ZACUALPAN,0.0,0,2,0,2
374,18001,2014,NAYARIT,ACAPONETA,8.202996828174559,0,2,0,2
375,18005,2014,NAYARIT,HUAJICORI,52.631578947368425,2,1,0,3
376,18010,2014,NAYARIT,ROSAMORADA,2.907568400546623,0,6,0,6
377,18013,2014,NAYARIT,SAN PEDRO LAGUNILLAS,0.0,0,16,0,16
378,18014,2014,NAYARIT,SANTA MARIA DEL ORO,4.461895413171515,1,2,3,6
379,18015,2014,NAYARIT,SANTIAGO IXCUINTLA,5.372069536068075,0,6,0,6
380,18017,2014,NAYARIT,TEPIC,8.67852380939858,0,1,2,3
381,18018,2014,NAYARIT,TUXPAN,0.0,0,3,0,3
382,19004,2014,NUEVO LEON,ALLENDE,9.204430399165464,0,1,0,1
383,19015,2014,NUEVO LEON,DR. COSS,116.55011655011656,1,1,1,3
384,19020,2014,NUEVO LEON,GRAL. BRAVO,36.18599601954044,1,0,0,1
385,19022,2014,NUEVO LEON,GRAL. TERAN,0.0,1,0,0,1
386,19024,2014,NUEVO LEON,GRAL. ZARAGOZA,33.65870077415012,1,2,3,6
387,19027,2014,NUEVO LEON,LOS HERRERAS,0.0,0,1,0,1
388,19029,2014,NUEVO LEON,HUALAHUISES,14.463407578825569,0,0,1,1
389,19030,2014,NUEVO LEON,ITURBIDE,0.0,1,0,0,1
390,19032,2014,NUEVO LEON,LAMPAZOS DE NARANJO,0.0,1,1,0,2
391,19033,2014,NUEVO LEON,LINARES,8.898041159796108,0,0,1,1
392,19034,2014,NUEVO LEON,MARIN,36.44314868804665,3,0,0,3
393,19035,2014,NUEVO LEON,MELCHOR OCAMPO,0.0,0,1,0,1
394,19038,2014,NUEVO LEON,MONTEMORELOS,11.841726862111551,0,0,1,1
395,19040,2014,NUEVO LEON,PARAS,96.71179883945841,1,2,0,3
396,19044,2014,NUEVO LEON,SABINAS HIDALGO,20.189783969311527,2,1,1,4
397,19049,2014,NUEVO LEON,SANTIAGO,7.413081618028613,1,0,0,1
419,21003,2014,PUEBLA,ACATLAN,17.717407352724052,0,0,1,1
420,21004,2014,PUEBLA,ACATZINGO,0.0,0,2,0,2
421,21015,2014,PUEBLA,AMOZOC,2.971356126936334,0,0,1,1
422,21022,2014,PUEBLA,ATZITZIHUACAN,17.117425539198905,1,0,1,2
423,21071,2014,PUEBLA,HUAUCHINANGO,6.1379190408478514,0,0,1,1
424,21085,2014,PUEBLA,IZUCAR DE MATAMOROS,13.736452423797031,0,2,0,2
425,21111,2014,PUEBLA,PANTEPEC,16.273393002441008,0,0,1,1
426,21113,2014,PUEBLA,PIAXTLA,43.62050163576881,1,1,0,2
427,21114,2014,PUEBLA,PUEBLA,3.2471348905293413,0,0,5,5
428,21118,2014,PUEBLA,LOS REYES DE JUAREZ,3.9134348217430435,0,1,1,2
429,21120,2014,PUEBLA,SAN ANTONIO CA?ADA,0.0,0,3,0,3
430,21141,2014,PUEBLA,SAN PEDRO YELOIXTLAHUACA,29.45508100147275,0,1,0,1
431,21149,2014,PUEBLA,SANTIAGO MIAHUATLAN,4.546901286773063,0,1,0,1
432,21157,2014,PUEBLA,TEHUITZINGO,8.827683615819211,0,2,0,2
433,21164,2014,PUEBLA,TEPEACA,5.354178936660063,0,2,0,2
434,21166,2014,PUEBLA,TEPEOJUMA,24.826216484607745,0,1,1,2
435,21168,2014,PUEBLA,TEPEXCO,0.0,0,3,0,3
436,21203,2014,PUEBLA,XOCHITLAN TODOS SANTOS,16.531658125309967,0,0,1,1
437,21206,2014,PUEBLA,ZACAPALA,0.0,0,1,0,1
438,22001,2014,QUERETARO,AMEALCO DE BONFIL,3.2155891763268323,4,4,0,8
439,22002,2014,QUERETARO,PINAL DE AMOLES,3.6909902926955303,0,3,0,3
440,22003,2014,QUERETARO,ARROYO SECO,7.745933384972888,0,3,0,3
441,22004,2014,QUERETARO,CADEREYTA DE MONTES,6.23217986071078,1,1,0,2
442,22005,2014,QUERETARO,COLON,3.4381392790221934,0,2,0,2
443,22008,2014,QUERETARO,HUIMILPAN,14.063115261292687,0,1,0,1
444,22009,2014,QUERETARO,JALPAN DE SERRA,3.9138943248532283,0,5,0,5
445,22010,2014,QUERETARO,LANDA DE MATAMOROS,10.03562647398264,0,21,0,21
446,22012,2014,QUERETARO,PEDRO ESCOBEDO,3.126661038676797,1,2,0,3
447,22013,2014,QUERETARO,PE?AMILLER,0.0,1,3,0,4
448,22014,2014,QUERETARO,QUERETARO,5.361997156894531,1,0,0,1
449,22015,2014,QUERETARO,SAN JOAQUIN,0.0,8,13,0,21
450,22016,2014,QUERETARO,SAN JUAN DEL RIO,2.8961642373365217,1,0,0,1
451,22018,2014,QUERETARO,TOLIMAN,0.0,0,4,0,4
452,23001,2014,QUINTANA ROO,COZUMEL,5.029232413402903,1,2,0,3
453,23003,2014,QUINTANA ROO,ISLA MUJERES,12.343393198790348,1,0,0,1
454,24001,2014,SAN LUIS POTOSI,AHUALULCO,16.090967603518557,0,1,0,1
455,24004,2014,SAN LUIS POTOSI,ARMADILLO DE LOS INFANTE,0.0,0,1,0,1
456,24009,2014,SAN LUIS POTOSI,CERRO DE SAN PEDRO,0.0,0,2,0,2
457,24015,2014,SAN LUIS POTOSI,CHARCAS,0.0,0,1,0,1
458,24018,2014,SAN LUIS POTOSI,HUEHUETLAN,0.0,0,1,0,1
459,24025,2014,SAN LUIS POTOSI,SALINAS,0.0,0,2,0,2
460,24028,2014,SAN LUIS POTOSI,SAN LUIS POTOSI,15.402457144928059,2,0,0,2
461,24031,2014,SAN LUIS POTOSI,SANTA CATARINA,8.449514152936207,0,0,2,2
462,24033,2014,SAN LUIS POTOSI,SANTO DOMINGO,0.0,0,2,0,2
463,24035,2014,SAN LUIS POTOSI,SOLEDAD DE GRACIANO SANCHEZ,7.467172443146817,0,2,0,2
464,24046,2014,SAN LUIS POTOSI,VILLA DE ARRIAGA,18.386859524393234,0,1,0,1
465,24049,2014,SAN LUIS POTOSI,VILLA DE RAMOS,10.546298249314491,0,1,0,1
466,24056,2014,SAN LUIS POTOSI,VILLA DE ARISTA,12.879958784131892,0,1,0,1
467,24058,2014,SAN LUIS POTOSI,EL NARANJO,19.516955354964626,0,1,0,1
468,25001,2014,SINALOA,AHOME,29.065647527378157,0,3,2,5
469,25005,2014,SINALOA,COSALA,17.967299514882914,0,2,0,2
470,25007,2014,SINALOA,CHOIX,54.54876053094128,0,7,0,7
471,25008,2014,SINALOA,ELOTA,23.30622043023283,0,1,0,1
472,25011,2014,SINALOA,GUASAVE,22.03475195164946,0,3,0,3
473,25012,2014,SINALOA,MAZATLAN,17.106337555937724,0,4,0,4
474,26006,2014,SONORA,ARIZPE,0.0,0,1,0,1
475,26012,2014,SONORA,BACUM,74.4927917269182,0,1,0,1
476,26014,2014,SONORA,BAVIACORA,28.089887640449444,0,1,0,1
477,26015,2014,SONORA,BAVISPE,0.0,0,2,0,2
478,26028,2014,SONORA,GRANADOS,0.0,0,1,0,1
479,26030,2014,SONORA,HERMOSILLO,12.367054167697255,0,3,0,3
480,26031,2014,SONORA,HUACHINERA,0.0,0,2,0,2
481,26038,2014,SONORA,MOCTEZUMA,21.367521367521366,0,1,0,1
482,26048,2014,SONORA,PUERTO PE?ASCO,8.719612151651496,0,2,0,2
483,26049,2014,SONORA,QUIRIEGO,0.0,0,1,0,1
484,26051,2014,SONORA,ROSARIO,38.270187523918864,0,1,0,1
485,26061,2014,SONORA,SOYOPA,0.0,0,1,0,1
486,26063,2014,SONORA,TEPACHE,0.0,0,1,0,1
487,26069,2014,SONORA,YECORA,99.23916639100231,0,1,0,1
488,26072,2014,SONORA,SAN IGNACIO RIO MUERTO,63.6672325976231,0,1,0,1
489,28002,2014,TAMAULIPAS,ALDAMA,13.573125212080082,0,1,0,1
490,28003,2014,TAMAULIPAS,ALTAMIRA,13.679180758581328,0,4,0,4
491,28005,2014,TAMAULIPAS,BURGOS,0.0,0,1,0,1
492,28006,2014,TAMAULIPAS,BUSTAMANTE,0.0,0,1,0,1
493,28007,2014,TAMAULIPAS,CAMARGO,33.482890243085784,0,2,0,2
494,28010,2014,TAMAULIPAS,CRUILLAS,0.0,0,1,0,1
495,28011,2014,TAMAULIPAS,GOMEZ FARIAS,11.381743683132255,0,2,0,2
496,28012,2014,TAMAULIPAS,GONZALEZ,29.929780131230572,0,2,0,2
497,28013,2014,TAMAULIPAS,G?EMEZ,38.31662302829044,0,1,0,1
498,28014,2014,TAMAULIPAS,GUERRERO,67.00915791824883,0,1,0,1
499,28015,2014,TAMAULIPAS,GUSTAVO DIAZ ORDAZ,0.0,1,0,0,1
500,28016,2014,TAMAULIPAS,HIDALGO,58.840835539864656,0,1,0,1
501,28017,2014,TAMAULIPAS,JAUMAVE,13.240648791790798,0,1,0,1
502,28018,2014,TAMAULIPAS,JIMENEZ,11.993283761093789,0,2,0,2
503,28019,2014,TAMAULIPAS,LLERA,23.077366872439853,0,1,0,1
504,28020,2014,TAMAULIPAS,MAINERO,116.32415664986428,0,1,0,1
505,28021,2014,TAMAULIPAS,EL MANTE,12.090645295011745,0,3,0,3
506,28023,2014,TAMAULIPAS,MENDEZ,0.0,0,1,0,1
507,28024,2014,TAMAULIPAS,MIER,167.99664006719863,0,1,0,1
508,28025,2014,TAMAULIPAS,MIGUEL ALEMAN,62.92800296131779,0,1,0,1
509,28028,2014,TAMAULIPAS,NUEVO MORELOS,0.0,0,1,0,1
510,28031,2014,TAMAULIPAS,PALMILLAS,111.42061281337048,0,2,0,2
511,28032,2014,TAMAULIPAS,REYNOSA,11.824776519935426,0,1,0,1
512,28034,2014,TAMAULIPAS,SAN CARLOS,117.88661451077057,0,1,0,1
513,28035,2014,TAMAULIPAS,SAN FERNANDO,52.429220552254456,0,2,0,2
514,28039,2014,TAMAULIPAS,TULA,14.507471347744088,0,2,0,2
515,28040,2014,TAMAULIPAS,VALLE HERMOSO,15.830299192654744,0,2,0,2
516,28042,2014,TAMAULIPAS,VILLAGRAN,110.82963901203293,0,1,0,1
517,28043,2014,TAMAULIPAS,XICOTENCATL,13.121063680895732,0,1,0,1
518,29005,2014,TLAXCALA,APIZACO,6.536631281702662,0,3,0,3
519,29013,2014,TLAXCALA,HUAMANTLA,2.3535226350039418,0,1,0,1
520,29014,2014,TLAXCALA,HUEYOTLIPAN,0.0,0,2,0,2
521,29019,2014,TLAXCALA,TEPETITLA DE LARDIZABAL,5.34045393858478,0,2,0,2
522,29025,2014,TLAXCALA,SAN PABLO DEL MONTE,1.4364720247073188,0,2,0,2
523,29028,2014,TLAXCALA,TEOLOCHOLCO,4.614461723040008,0,1,0,1
524,29033,2014,TLAXCALA,TLAXCALA,3.3409432596469735,0,2,0,2
525,29039,2014,TLAXCALA,XALOZTOC,4.593688272313841,0,1,1,2
526,30007,2014,VERACRUZ,CAMARON DE TEJEDA,0.0,0,2,0,2
527,30008,2014,VERACRUZ,ALPATLAHUAC,0.0,0,1,0,1
528,30009,2014,VERACRUZ,ALTO LUCERO DE GUTIERREZ BARRIOS,0.0,0,1,3,4
529,30022,2014,VERACRUZ,ATZACAN,4.9842994567113585,0,1,0,1
530,30029,2014,VERACRUZ,CALCAHUALCO,0.0,0,1,0,1
531,30039,2014,VERACRUZ,COATZACOALCOS,3.931075149053266,0,0,4,4
532,30085,2014,VERACRUZ,IXTACZOQUITLAN,1.5294027682190103,0,1,0,1
533,30087,2014,VERACRUZ,XALAPA,5.022623643891617,0,0,1,1
534,30101,2014,VERACRUZ,MARIANO ESCOBEDO,2.9462891488170646,0,1,0,1
535,30105,2014,VERACRUZ,MEDELLIN,3.3826066366742213,0,1,0,1
536,30108,2014,VERACRUZ,MINATITLAN,5.701976685250888,0,0,1,1
537,30118,2014,VERACRUZ,ORIZABA,5.7853630315302285,0,0,2,2
538,30125,2014,VERACRUZ,PASO DEL MACHO,17.143836790673753,0,3,0,3
539,30134,2014,VERACRUZ,PUENTE NACIONAL,4.6289867148081285,0,1,0,1
540,30135,2014,VERACRUZ,RAFAEL DELGADO,9.878982464806123,0,2,0,2
541,30138,2014,VERACRUZ,RIO BLANCO,2.460993256878476,0,1,0,1
542,30187,2014,VERACRUZ,TONAYAN,0.0,0,2,0,2
543,30191,2014,VERACRUZ,URSULO GALVAN,0.0,0,2,0,2
544,30199,2014,VERACRUZ,ZARAGOZA,0.0,0,1,0,1
545,31009,2014,YUCATAN,CANSAHCAB,0.0,1,0,0,1
546,31010,2014,YUCATAN,CANTAMAYEC,0.0,0,1,0,1
547,31012,2014,YUCATAN,CENOTILLO,0.0,0,1,0,1
548,31016,2014,YUCATAN,CHACSINKIN,0.0,0,0,1,1
549,31019,2014,YUCATAN,CHEMAX,0.0,0,1,0,1
550,31021,2014,YUCATAN,CHICHIMILA,0.0,0,1,0,1
551,31032,2014,YUCATAN,ESPITA,0.0,0,0,1,1
552,31034,2014,YUCATAN,HOCABA,0.0,0,1,0,1
553,31035,2014,YUCATAN,HOCTUN,0.0,0,1,0,1
554,31036,2014,YUCATAN,HOMUN,0.0,0,1,2,3
555,31038,2014,YUCATAN,HUNUCMA,3.2540431486121513,1,0,0,1
556,31041,2014,YUCATAN,KANASIN,3.8115082138002014,0,1,0,1
557,31046,2014,YUCATAN,MAMA,0.0,0,1,0,1
558,31049,2014,YUCATAN,MAYAPAN,0.0,0,1,0,1
559,31050,2014,YUCATAN,MERIDA,2.287139534771744,0,0,2,2
560,31052,2014,YUCATAN,MOTUL,2.943080816999234,0,0,1,1
561,31054,2014,YUCATAN,MUXUPIP,0.0,0,1,0,1
562,31056,2014,YUCATAN,OXKUTZCAB,0.0,0,1,4,5
563,31060,2014,YUCATAN,QUINTANA ROO,0.0,0,1,0,1
564,31063,2014,YUCATAN,SAMAHIL,0.0,0,2,0,2
565,31073,2014,YUCATAN,TAHDZIU,0.0,1,0,1,2
566,31079,2014,YUCATAN,TEKAX,27.1290107776161,0,1,0,1
567,31080,2014,YUCATAN,TEKIT,0.0,0,1,0,1
568,31081,2014,YUCATAN,TEKOM,0.0,0,1,0,1
569,31083,2014,YUCATAN,TELCHAC PUERTO,0.0,0,0,1,1
570,31092,2014,YUCATAN,TIXCACALCUPUL,0.0,0,1,0,1
571,31096,2014,YUCATAN,TIZIMIN,1.367278295824332,0,1,0,1
572,31098,2014,YUCATAN,TZUCACAB,0.0,1,0,2,3
573,31099,2014,YUCATAN,UAYMA,0.0,0,1,0,1
574,31102,2014,YUCATAN,VALLADOLID,0.0,0,4,0,4
575,32001,2014,ZACATECAS,APOZOL,0.0,1,0,0,1
576,32002,2014,ZACATECAS,APULCO,0.0,0,0,1,1
577,32003,2014,ZACATECAS,ATOLINGA,0.0,2,6,0,8
578,32004,2014,ZACATECAS,BENITO JUAREZ,0.0,1,4,0,5
579,32009,2014,ZACATECAS,CHALCHIHUITES,9.46521533364884,2,0,0,2
580,32010,2014,ZACATECAS,FRESNILLO,15.952031303515547,7,3,2,12
581,32014,2014,ZACATECAS,GENERAL FRANCISCO R. MURGUIA,0.0,0,1,0,1
582,32015,2014,ZACATECAS,EL PLATEADO DE JOAQUIN AMARO,0.0,2,0,0,2
583,32016,2014,ZACATECAS,GENERAL PANFILO NATERA,0.0,0,1,0,1
584,32017,2014,ZACATECAS,GUADALUPE,1.2500703164553006,5,5,1,11
585,32019,2014,ZACATECAS,JALPA,16.980090843486014,1,19,0,20
586,32022,2014,ZACATECAS,JUAN ALDAMA,4.867838193058462,1,7,0,8
587,32023,2014,ZACATECAS,JUCHIPILA,24.422012373819605,3,6,0,9
588,32024,2014,ZACATECAS,LORETO,2.0676108756332057,0,5,0,5
589,32025,2014,ZACATECAS,LUIS MOYA,0.0,0,4,0,4
590,32030,2014,ZACATECAS,MOMAX,0.0,4,2,0,6
591,32031,2014,ZACATECAS,MONTE ESCOBEDO,0.0,2,0,0,2
592,32032,2014,ZACATECAS,MORELOS,0.0,1,2,0,3
593,32033,2014,ZACATECAS,MOYAHUA DE ESTRADA,0.0,1,0,1,2
594,32034,2014,ZACATECAS,NOCHISTLAN DE MEJIA,17.900615781182875,6,10,0,16
595,32036,2014,ZACATECAS,OJOCALIENTE,12.272950417280311,0,2,0,2
596,32037,2014,ZACATECAS,PANUCO,0.0,0,3,6,9
597,32038,2014,ZACATECAS,PINOS,11.45409770345341,0,7,0,7
598,32039,2014,ZACATECAS,RIO GRANDE,4.785223230663711,1,2,0,3
599,32040,2014,ZACATECAS,SAIN ALTO,9.288069474759672,1,1,0,2
600,32042,2014,ZACATECAS,SOMBRERETE,16.343073805321307,1,1,0,2
601,32043,2014,ZACATECAS,SUSTICACAN,0.0,0,1,0,1
602,32045,2014,ZACATECAS,TEPECHITLAN,0.0,2,5,0,7
603,32046,2014,ZACATECAS,TEPETONGO,0.0,2,5,0,7
604,32048,2014,ZACATECAS,TLALTENANGO DE SANCHEZ ROMAN,3.9226454320793933,2,1,0,3
605,32049,2014,ZACATECAS,VALPARAISO,30.009302883894005,19,4,1,24
606,32050,2014,ZACATECAS,VETAGRANDE,0.0,0,6,0,6
607,32051,2014,ZACATECAS,VILLA DE COS,0.0,1,2,0,3
608,32052,2014,ZACATECAS,VILLA GARCIA,0.0,0,0,1,1
609,32055,2014,ZACATECAS,VILLANUEVA,6.803878210580031,5,5,0,10
610,32056,2014,ZACATECAS,ZACATECAS,2.1711440481704494,0,0,3,3
